time;solar;injection;conso;power_limit;delay
2025-08-07 14:32:58.735;438;-5;443;-1;
2025-08-07 14:32:59.235;438;4;434;-1;
2025-08-07 14:32:59.735;438;4;434;-1;
2025-08-07 14:33:00.235;439;16;423;-1;
2025-08-07 14:33:00.738;439;16;423;-1;
2025-08-07 14:33:01.236;445;27;418;-1;
2025-08-07 14:33:01.735;445;27;418;-1;
2025-08-07 14:33:02.235;453;29;424;-1;
2025-08-07 14:33:02.735;453;29;424;-1;
2025-08-07 14:33:03.450;483;66;417;-1;
2025-08-07 14:33:03.734;483;66;417;-1;
2025-08-07 14:33:04.235;497;67;430;-1;
2025-08-07 14:33:04.734;497;67;430;-1;
2025-08-07 14:33:05.240;512;37;475;-1;
2025-08-07 14:33:05.735;512;37;475;-1;
2025-08-07 14:33:06.235;542;-134;676;-1;
2025-08-07 14:33:06.735;542;-134;676;-1;
2025-08-07 14:33:07.235;695;42;653;-1;
2025-08-07 14:33:07.735;695;42;653;-1;
2025-08-07 14:33:08.235;678;-10;688;-1;
2025-08-07 14:33:08.734;678;-10;688;-1;
2025-08-07 14:33:09.234;710;67;643;-1;
2025-08-07 14:33:09.735;710;67;643;-1;
2025-08-07 14:33:10.235;745;319;426;-1;
2025-08-07 14:33:10.735;745;319;426;-1;
2025-08-07 14:33:11.238;791;346;445;-1;
2025-08-07 14:33:11.735;791;346;445;-1;
2025-08-07 14:33:12.235;815;373;442;-1;
2025-08-07 14:33:12.734;815;373;442;-1;
2025-08-07 14:33:13.234;853;410;443;-1;
2025-08-07 14:33:13.499;9;write_maxpower_HTTP. Ecriture HTTP de maxpower = 132W pour 3 devices
2025-08-07 14:33:13.735;853;410;443;-1;
2025-08-07 14:33:14.239;901;472;429;-1;
2025-08-07 14:33:14.735;901;472;429;-1;
2025-08-07 14:33:15.235;982;555;427;-1;
2025-08-07 14:33:15.735;982;555;427;-1;
2025-08-07 14:33:16.235;1018;593;425;-1;
2025-08-07 14:33:16.734;1018;593;425;-1;
2025-08-07 14:33:17.236;1084;657;427;-1;
2025-08-07 14:33:17.735;1084;657;427;-1;
2025-08-07 14:33:18.234;1086;659;427;-1;
2025-08-07 14:33:18.734;1086;659;427;-1;
2025-08-07 14:33:19.236;1130;707;423;-1;
2025-08-07 14:33:19.293;9;write_maxpower_HTTP. Fin d'exécution de la procédure
2025-08-07 14:33:19.735;1130;707;423;-1;
2025-08-07 14:33:20.235;1142;672;470;-1;
2025-08-07 14:33:20.734;1142;672;470;-1;
2025-08-07 14:33:21.236;1176;504;672;-1;
2025-08-07 14:33:21.734;1176;504;672;-1;
2025-08-07 14:33:22.238;1202;625;577;-1;
2025-08-07 14:33:22.735;1202;625;577;-1;
2025-08-07 14:33:23.235;1236;600;636;-1;
2025-08-07 14:33:23.734;1236;600;636;-1;
2025-08-07 14:33:24.236;1154;451;703;-1;
2025-08-07 14:33:24.734;1154;451;703;-1;
2025-08-07 14:33:25.239;1065;637;428;-1;
2025-08-07 14:33:25.734;1065;637;428;-1;
2025-08-07 14:33:26.238;1012;588;424;-1;
2025-08-07 14:33:26.734;1012;588;424;-1;
2025-08-07 14:33:27.239;932;507;425;-1;
2025-08-07 14:33:27.734;932;507;425;-1;
2025-08-07 14:33:28.237;908;483;425;-1;
2025-08-07 14:33:28.734;908;483;425;-1;
2025-08-07 14:33:29.362;908;481;427;-1;
2025-08-07 14:33:29.741;908;481;427;-1;
2025-08-07 14:33:30.388;908;483;425;-1;
2025-08-07 14:33:30.846;908;483;425;-1;
2025-08-07 14:33:31.271;905;480;425;-1;
2025-08-07 14:33:31.932;905;480;425;-1;
2025-08-07 14:33:32.239;905;478;427;-1;
2025-08-07 14:33:32.804;905;478;427;-1;
2025-08-07 14:33:33.441;902;476;426;-1;
2025-08-07 14:33:33.734;902;476;426;-1;
2025-08-07 14:33:34.239;905;482;423;-1;
2025-08-07 14:33:34.734;905;482;423;-1;
2025-08-07 14:33:35.244;878;409;469;-1;
2025-08-07 14:33:35.734;878;409;469;-1;
2025-08-07 14:33:36.244;824;155;669;-1;
2025-08-07 14:33:36.734;824;155;669;-1;
2025-08-07 14:33:37.243;766;83;683;-1;
2025-08-07 14:33:37.734;766;83;683;-1;
2025-08-07 14:33:38.242;746;100;646;-1;
2025-08-07 14:33:38.734;746;100;646;-1;
2025-08-07 14:33:39.242;746;108;638;-1;
2025-08-07 14:33:39.734;746;108;638;-1;
2025-08-07 14:33:40.244;747;322;425;-1;
2025-08-07 14:33:40.734;747;322;425;-1;
2025-08-07 14:33:41.242;747;330;417;-1;
2025-08-07 14:33:41.733;747;330;417;-1;
2025-08-07 14:33:42.242;746;325;421;-1;
2025-08-07 14:33:42.734;746;325;421;-1;
2025-08-07 14:33:43.245;745;306;439;-1;
2025-08-07 14:33:43.734;745;306;439;-1;
2025-08-07 14:33:44.264;745;328;417;-1;
2025-08-07 14:33:44.734;745;328;417;-1;
2025-08-07 14:33:45.244;744;325;419;-1;
2025-08-07 14:33:45.734;744;325;419;-1;
2025-08-07 14:33:46.244;747;327;420;-1;
2025-08-07 14:33:46.733;747;327;420;-1;
2025-08-07 14:33:47.244;748;314;434;-1;
2025-08-07 14:33:47.734;748;314;434;-1;
2025-08-07 14:33:48.245;747;328;419;-1;
2025-08-07 14:33:48.733;747;328;419;-1;
2025-08-07 14:33:49.245;745;326;419;-1;
2025-08-07 14:33:49.733;745;326;419;-1;
2025-08-07 14:33:50.247;747;286;461;-1;
2025-08-07 14:33:50.733;747;286;461;-1;
2025-08-07 14:33:51.247;747;116;631;-1;
2025-08-07 14:33:51.733;747;116;631;-1;
2025-08-07 14:33:52.247;745;79;666;-1;
2025-08-07 14:33:52.734;745;79;666;-1;
2025-08-07 14:33:53.265;744;130;614;-1;
2025-08-07 14:33:53.733;744;130;614;-1;
2025-08-07 14:33:54.265;745;69;676;-1;
2025-08-07 14:33:54.734;745;69;676;-1;
2025-08-07 14:33:55.266;749;346;403;-1;
2025-08-07 14:33:55.733;749;346;403;-1;
2025-08-07 14:33:56.247;746;341;405;-1;
2025-08-07 14:33:56.733;746;341;405;-1;
2025-08-07 14:33:57.247;746;345;401;-1;
2025-08-07 14:33:57.733;746;345;401;-1;
2025-08-07 14:33:58.248;745;338;407;-1;
2025-08-07 14:33:58.733;745;338;407;-1;
2025-08-07 14:33:59.265;746;328;418;-1;
2025-08-07 14:33:59.732;746;328;418;-1;
2025-08-07 14:34:00.265;745;311;434;-1;
2025-08-07 14:34:00.733;745;311;434;-1;
2025-08-07 14:34:01.247;745;315;430;-1;
2025-08-07 14:34:01.732;745;315;430;-1;
2025-08-07 14:34:02.248;743;315;428;-1;
2025-08-07 14:34:02.736;743;315;428;-1;
2025-08-07 14:34:03.461;747;317;430;-1;
2025-08-07 14:34:03.733;747;317;430;-1;
2025-08-07 14:34:04.248;747;317;430;-1;
2025-08-07 14:34:04.732;747;317;430;-1;
2025-08-07 14:34:05.267;746;254;492;-1;
2025-08-07 14:34:05.738;746;254;492;-1;
2025-08-07 14:34:06.267;745;53;692;-1;
2025-08-07 14:34:06.732;745;53;692;-1;
2025-08-07 14:34:07.268;747;95;652;-1;
2025-08-07 14:34:07.735;747;95;652;-1;
2025-08-07 14:34:08.268;748;119;629;-1;
2025-08-07 14:34:08.733;748;119;629;-1;
2025-08-07 14:34:09.268;745;245;500;-1;
2025-08-07 14:34:09.733;745;245;500;-1;
2025-08-07 14:34:10.271;746;270;476;-1;
2025-08-07 14:34:10.746;746;270;476;-1;
2025-08-07 14:34:11.252;748;264;484;-1;
2025-08-07 14:34:11.643;9;write_maxpower_HTTP. Ecriture HTTP de maxpower = 88W pour 3 devices
2025-08-07 14:34:11.732;748;264;484;-1;
2025-08-07 14:34:12.269;747;285;462;-1;
2025-08-07 14:34:12.733;747;285;462;-1;
2025-08-07 14:34:13.251;749;292;457;-1;
2025-08-07 14:34:13.741;749;292;457;-1;
2025-08-07 14:34:14.252;748;288;460;-1;
2025-08-07 14:34:14.732;748;288;460;-1;
2025-08-07 14:34:15.252;744;286;458;-1;
2025-08-07 14:34:15.732;744;286;458;-1;
2025-08-07 14:34:16.253;748;293;455;-1;
2025-08-07 14:34:16.732;748;293;455;-1;
2025-08-07 14:34:16.784;9;write_maxpower_HTTP. Fin d'exécution de la procédure
2025-08-07 14:34:17.253;745;283;462;-1;
2025-08-07 14:34:17.733;745;283;462;-1;
2025-08-07 14:34:18.272;746;-41;787;-1;
2025-08-07 14:34:18.732;746;-41;787;-1;
2025-08-07 14:34:19.273;747;139;608;-1;
2025-08-07 14:34:19.733;747;139;608;-1;
2025-08-07 14:34:20.273;745;58;687;-1;
2025-08-07 14:34:20.732;745;58;687;-1;
2025-08-07 14:34:21.252;745;58;687;-1;
2025-08-07 14:34:21.732;746;292;454;-1;
2025-08-07 14:34:22.251;746;292;454;-1;
2025-08-07 14:34:22.733;746;292;454;-1;
2025-08-07 14:34:23.252;746;292;454;-1;
2025-08-07 14:34:23.733;707;258;449;-1;
2025-08-07 14:34:24.252;707;258;449;-1;
2025-08-07 14:34:24.732;618;162;456;-1;
2025-08-07 14:34:25.252;618;162;456;-1;
2025-08-07 14:34:25.733;540;67;473;-1;
2025-08-07 14:34:26.251;540;67;473;-1;
2025-08-07 14:34:26.732;508;-119;627;-1;
2025-08-07 14:34:27.254;508;-119;627;-1;
2025-08-07 14:34:27.732;496;-142;638;-1;
2025-08-07 14:34:28.252;496;-142;638;-1;
2025-08-07 14:34:28.733;495;-100;595;-1;
2025-08-07 14:34:29.252;495;-100;595;-1;
2025-08-07 14:34:29.731;496;44;452;-1;
2025-08-07 14:34:30.252;496;44;452;-1;
2025-08-07 14:34:30.733;496;38;458;-1;
2025-08-07 14:34:31.251;496;38;458;-1;
2025-08-07 14:34:31.733;494;47;447;-1;
2025-08-07 14:34:32.252;494;47;447;-1;
2025-08-07 14:34:32.731;494;49;445;-1;
2025-08-07 14:34:33.251;494;49;445;-1;
2025-08-07 14:34:33.731;494;49;445;-1;
2025-08-07 14:34:34.251;494;49;445;-1;
2025-08-07 14:34:34.731;494;6;488;-1;
2025-08-07 14:34:35.257;494;6;488;-1;
2025-08-07 14:34:35.732;493;-186;679;-1;
2025-08-07 14:34:36.251;493;-186;679;-1;
2025-08-07 14:34:36.732;492;-123;615;-1;
2025-08-07 14:34:37.252;492;-123;615;-1;
2025-08-07 14:34:37.894;493;-88;581;-1;
2025-08-07 14:34:38.251;493;-88;581;-1;
2025-08-07 14:34:38.892;496;-142;638;-1;
2025-08-07 14:34:39.354;496;-142;638;-1;
2025-08-07 14:34:39.775;498;-165;663;-1;
2025-08-07 14:34:40.438;498;-165;663;-1;
2025-08-07 14:34:40.732;491;-100;591;-1;
2025-08-07 14:34:41.310;491;-100;591;-1;
2025-08-07 14:34:41.947;494;-14;508;-1;
2025-08-07 14:34:42.251;494;-14;508;-1;
2025-08-07 14:34:42.731;494;-3;497;-1;
2025-08-07 14:34:43.250;494;-3;497;-1;
2025-08-07 14:34:43.732;496;-13;509;-1;
2025-08-07 14:34:44.251;496;-13;509;-1;
2025-08-07 14:34:44.732;495;8;487;-1;
2025-08-07 14:34:45.250;495;8;487;-1;
2025-08-07 14:34:45.731;497;14;483;-1;
2025-08-07 14:34:46.251;497;14;483;-1;
2025-08-07 14:34:46.731;493;-8;501;-1;
2025-08-07 14:34:47.250;493;-8;501;-1;
2025-08-07 14:34:47.731;494;-8;502;-1;
2025-08-07 14:34:48.250;494;-8;502;-1;
2025-08-07 14:34:48.731;494;9;485;-1;
2025-08-07 14:34:49.251;494;9;485;-1;
2025-08-07 14:34:49.731;493;-90;583;-1;
2025-08-07 14:34:50.250;493;-90;583;-1;
2025-08-07 14:34:50.731;494;29;465;-1;
2025-08-07 14:34:51.250;494;29;465;-1;
2025-08-07 14:34:51.731;497;31;466;-1;
2025-08-07 14:34:52.250;497;31;466;-1;
2025-08-07 14:34:52.731;496;17;479;-1;
2025-08-07 14:34:53.252;496;17;479;-1;
2025-08-07 14:34:53.731;497;-6;503;-1;
2025-08-07 14:34:54.250;497;-6;503;-1;
2025-08-07 14:34:54.730;494;-4;498;-1;
2025-08-07 14:34:55.250;494;-4;498;-1;
2025-08-07 14:34:55.731;496;24;472;-1;
2025-08-07 14:34:56.250;496;24;472;-1;
2025-08-07 14:34:56.731;495;-7;502;-1;
2025-08-07 14:34:57.250;495;-7;502;-1;
2025-08-07 14:34:57.731;492;-10;502;-1;
2025-08-07 14:34:58.250;492;-10;502;-1;
2025-08-07 14:34:58.731;495;5;490;-1;
2025-08-07 14:34:59.250;495;5;490;-1;
2025-08-07 14:34:59.731;492;4;488;-1;
2025-08-07 14:35:00.250;492;4;488;-1;
2025-08-07 14:35:00.730;494;3;491;-1;
2025-08-07 14:35:01.250;494;3;491;-1;
2025-08-07 14:35:01.731;496;7;489;-1;
2025-08-07 14:35:02.250;496;7;489;-1;
2025-08-07 14:35:02.730;494;5;489;-1;
2025-08-07 14:35:03.380;494;5;489;-1;
2025-08-07 14:35:03.730;495;16;479;-1;
2025-08-07 14:35:04.250;495;16;479;-1;
2025-08-07 14:35:04.730;492;9;483;-1;
2025-08-07 14:35:05.250;492;9;483;-1;
2025-08-07 14:35:05.731;497;3;494;-1;
2025-08-07 14:35:06.250;497;3;494;-1;
2025-08-07 14:35:06.731;494;10;484;-1;
2025-08-07 14:35:07.250;494;10;484;-1;
2025-08-07 14:35:07.730;496;-215;711;-1;
2025-08-07 14:35:08.249;496;-215;711;-1;
2025-08-07 14:35:08.730;494;-148;642;-1;
2025-08-07 14:35:09.250;494;-148;642;-1;
2025-08-07 14:35:09.730;493;17;476;-1;
2025-08-07 14:35:10.250;493;17;476;-1;
2025-08-07 14:35:10.730;495;40;455;-1;
2025-08-07 14:35:11.250;495;40;455;-1;
2025-08-07 14:35:11.730;496;44;452;-1;
2025-08-07 14:35:12.250;496;44;452;-1;
2025-08-07 14:35:12.730;494;31;463;-1;
2025-08-07 14:35:13.249;494;31;463;-1;
2025-08-07 14:35:13.732;493;44;449;-1;
2025-08-07 14:35:14.280;493;44;449;-1;
2025-08-07 14:35:14.730;492;41;451;-1;
2025-08-07 14:35:15.250;492;41;451;-1;
2025-08-07 14:35:15.730;495;40;455;-1;
2025-08-07 14:35:16.250;495;40;455;-1;
2025-08-07 14:35:16.730;494;41;453;-1;
2025-08-07 14:35:17.249;494;41;453;-1;
2025-08-07 14:35:17.731;496;42;454;-1;
2025-08-07 14:35:18.250;496;42;454;-1;
2025-08-07 14:35:18.730;492;43;449;-1;
2025-08-07 14:35:19.249;492;43;449;-1;
2025-08-07 14:35:19.730;494;41;453;-1;
2025-08-07 14:35:20.249;494;41;453;-1;
2025-08-07 14:35:20.730;492;42;450;-1;
2025-08-07 14:35:21.249;492;42;450;-1;
2025-08-07 14:35:21.730;494;47;447;-1;
2025-08-07 14:35:22.249;494;47;447;-1;
2025-08-07 14:35:22.737;494;24;470;-1;
2025-08-07 14:35:23.249;494;24;470;-1;
2025-08-07 14:35:23.730;491;26;465;-1;
2025-08-07 14:35:24.249;491;26;465;-1;
2025-08-07 14:35:24.581;9;write_maxpower_HTTP. Ecriture HTTP de maxpower = 44W pour 3 devices
2025-08-07 14:35:24.730;494;30;464;-1;
2025-08-07 14:35:25.249;494;30;464;-1;
2025-08-07 14:35:25.730;495;47;448;-1;
2025-08-07 14:35:26.249;495;47;448;-1;
2025-08-07 14:35:26.730;493;46;447;-1;
2025-08-07 14:35:27.249;493;46;447;-1;
2025-08-07 14:35:27.730;494;41;453;-1;
2025-08-07 14:35:28.249;494;41;453;-1;
2025-08-07 14:35:28.729;496;47;449;-1;
2025-08-07 14:35:29.249;496;47;449;-1;
2025-08-07 14:35:29.702;9;write_maxpower_HTTP. Fin d'exécution de la procédure
2025-08-07 14:35:29.759;495;47;448;-1;
2025-08-07 14:35:30.249;495;47;448;-1;
2025-08-07 14:35:30.730;496;-168;664;-1;
2025-08-07 14:35:31.249;496;-168;664;-1;
2025-08-07 14:35:31.729;494;-60;554;-1;
2025-08-07 14:35:32.249;494;-60;554;-1;
2025-08-07 14:35:32.729;494;-106;600;-1;
2025-08-07 14:35:33.250;494;-106;600;-1;
2025-08-07 14:35:33.730;495;31;464;-1;
2025-08-07 14:35:34.250;495;31;464;-1;
2025-08-07 14:35:34.729;495;45;450;-1;
2025-08-07 14:35:35.249;495;45;450;-1;
2025-08-07 14:35:35.730;495;51;444;-1;
2025-08-07 14:35:36.248;495;51;444;-1;
2025-08-07 14:35:36.729;495;53;442;-1;
2025-08-07 14:35:37.249;495;53;442;-1;
2025-08-07 14:35:37.729;493;52;441;-1;
2025-08-07 14:35:38.249;493;52;441;-1;
2025-08-07 14:35:38.729;498;-85;583;-1;
2025-08-07 14:35:39.249;498;-85;583;-1;
2025-08-07 14:35:39.729;494;-90;584;-1;
2025-08-07 14:35:40.249;494;-90;584;-1;
2025-08-07 14:35:40.729;491;-50;541;-1;
2025-08-07 14:35:41.249;491;-50;541;-1;
2025-08-07 14:35:41.729;494;38;456;-1;
2025-08-07 14:35:42.248;494;38;456;-1;
2025-08-07 14:35:42.730;491;43;448;-1;
2025-08-07 14:35:43.249;491;43;448;-1;
2025-08-07 14:35:43.731;497;64;433;-1;
2025-08-07 14:35:44.249;497;64;433;-1;
2025-08-07 14:35:44.729;496;50;446;-1;
2025-08-07 14:35:45.248;496;50;446;-1;
2025-08-07 14:35:45.729;496;64;432;-1;
2025-08-07 14:35:46.400;496;64;432;-1;
2025-08-07 14:35:46.755;496;61;435;-1;
2025-08-07 14:35:47.399;496;61;435;-1;
2025-08-07 14:35:47.729;492;-107;599;-1;
2025-08-07 14:35:48.281;492;-107;599;-1;
2025-08-07 14:35:48.943;491;-100;591;-1;
2025-08-07 14:35:49.249;491;-100;591;-1;
2025-08-07 14:35:49.815;437;-109;546;-1;
2025-08-07 14:35:50.452;437;-109;546;-1;
2025-08-07 14:35:50.728;283;-265;548;-1;
2025-08-07 14:35:51.248;283;-265;548;-1;
2025-08-07 14:35:51.729;271;-276;547;-1;
2025-08-07 14:35:52.249;271;-276;547;-1;
2025-08-07 14:35:52.729;260;-266;526;-1;
2025-08-07 14:35:53.249;260;-266;526;-1;
2025-08-07 14:35:53.728;250;-267;517;-1;
2025-08-07 14:35:54.248;250;-267;517;-1;
2025-08-07 14:35:54.729;240;-240;480;-1;
2025-08-07 14:35:55.248;240;-240;480;-1;
2025-08-07 14:35:55.728;232;-252;484;-1;
2025-08-07 14:35:56.228;232;-252;484;-1;
2025-08-07 14:35:56.729;225;-245;470;-1;
2025-08-07 14:35:57.228;225;-245;470;-1;
2025-08-07 14:35:57.730;225;-239;464;-1;
2025-08-07 14:35:58.228;225;-239;464;-1;
2025-08-07 14:35:58.729;221;-255;476;-1;
2025-08-07 14:35:59.228;221;-255;476;-1;
2025-08-07 14:35:59.728;224;-243;467;-1;
2025-08-07 14:36:00.228;224;-243;467;-1;
2025-08-07 14:36:00.729;225;-247;472;-1;
2025-08-07 14:36:01.228;225;-247;472;-1;
2025-08-07 14:36:01.728;223;-318;541;-1;
2025-08-07 14:36:02.229;223;-318;541;-1;
2025-08-07 14:36:02.728;224;-248;472;-1;
2025-08-07 14:36:03.229;224;-248;472;-1;
2025-08-07 14:36:03.728;224;-218;442;-1;
2025-08-07 14:36:04.228;224;-218;442;-1;
2025-08-07 14:36:04.729;225;-237;462;-1;
2025-08-07 14:36:05.228;225;-237;462;-1;
2025-08-07 14:36:05.728;224;-291;515;-1;
2025-08-07 14:36:06.228;224;-291;515;-1;
2025-08-07 14:36:06.728;225;-272;497;-1;
2025-08-07 14:36:07.228;225;-272;497;-1;
2025-08-07 14:36:07.729;226;-234;460;-1;
2025-08-07 14:36:08.228;226;-234;460;-1;
2025-08-07 14:36:08.729;225;-260;485;-1;
2025-08-07 14:36:09.228;225;-260;485;-1;
2025-08-07 14:36:09.728;224;-247;471;-1;
2025-08-07 14:36:10.227;224;-247;471;-1;
2025-08-07 14:36:10.728;226;-242;468;-1;
2025-08-07 14:36:11.227;226;-242;468;-1;
2025-08-07 14:36:11.727;225;-238;463;-1;
2025-08-07 14:36:12.228;225;-238;463;-1;
2025-08-07 14:36:12.729;225;-251;476;-1;
2025-08-07 14:36:13.228;225;-251;476;-1;
2025-08-07 14:36:13.728;225;-248;473;-1;
2025-08-07 14:36:14.227;225;-248;473;-1;
2025-08-07 14:36:14.727;226;-243;469;-1;
2025-08-07 14:36:15.227;226;-243;469;-1;
2025-08-07 14:36:15.727;226;-240;466;-1;
2025-08-07 14:36:16.228;226;-240;466;-1;
2025-08-07 14:36:16.727;225;-237;462;-1;
2025-08-07 14:36:17.228;225;-237;462;-1;
2025-08-07 14:36:17.728;224;-243;467;-1;
2025-08-07 14:36:18.227;224;-243;467;-1;
2025-08-07 14:36:18.727;225;-254;479;-1;
2025-08-07 14:36:19.227;225;-254;479;-1;
2025-08-07 14:36:19.728;225;-458;683;-1;
2025-08-07 14:36:20.227;225;-458;683;-1;
2025-08-07 14:36:20.728;224;-390;614;-1;
2025-08-07 14:36:21.227;224;-390;614;-1;
2025-08-07 14:36:21.728;222;-449;671;-1;
2025-08-07 14:36:22.227;222;-449;671;-1;
2025-08-07 14:36:22.728;226;-479;705;-1;
2025-08-07 14:36:23.227;226;-479;705;-1;
2025-08-07 14:36:23.728;225;-512;737;-1;
2025-08-07 14:36:24.227;225;-512;737;-1;
2025-08-07 14:36:24.728;225;-211;436;-1;
2025-08-07 14:36:25.227;225;-211;436;-1;
2025-08-07 14:36:25.727;223;-200;423;-1;
2025-08-07 14:36:26.227;223;-200;423;-1;
2025-08-07 14:36:26.727;224;-208;432;-1;
2025-08-07 14:36:27.227;224;-208;432;-1;
2025-08-07 14:36:27.729;224;-225;449;-1;
2025-08-07 14:36:28.227;224;-225;449;-1;
2025-08-07 14:36:28.728;223;-212;435;-1;
2025-08-07 14:36:29.227;223;-212;435;-1;
2025-08-07 14:36:29.727;225;-207;432;-1;
2025-08-07 14:36:30.227;225;-207;432;-1;
2025-08-07 14:36:30.727;225;-211;436;-1;
2025-08-07 14:36:31.228;225;-211;436;-1;
2025-08-07 14:36:31.727;223;-205;428;-1;
2025-08-07 14:36:32.227;223;-205;428;-1;
2025-08-07 14:36:32.727;224;-228;452;-1;
2025-08-07 14:36:33.226;224;-228;452;-1;
2025-08-07 14:36:33.726;225;-238;463;-1;
2025-08-07 14:36:33.896;9;write_maxpower_HTTP. Ecriture HTTP de maxpower = 88W pour 3 devices
2025-08-07 14:36:34.227;225;-238;463;-1;
2025-08-07 14:36:34.726;225;-199;424;-1;
2025-08-07 14:36:35.227;225;-199;424;-1;
2025-08-07 14:36:35.727;224;-204;428;-1;
2025-08-07 14:36:36.227;224;-204;428;-1;
2025-08-07 14:36:36.727;223;-203;426;-1;
2025-08-07 14:36:37.227;223;-203;426;-1;
2025-08-07 14:36:37.728;223;-199;422;-1;
2025-08-07 14:36:38.227;223;-199;422;-1;
2025-08-07 14:36:38.727;222;-203;425;-1;
2025-08-07 14:36:39.172;9;write_maxpower_HTTP. Fin d'exécution de la procédure
2025-08-07 14:36:39.227;222;-203;425;-1;
2025-08-07 14:36:39.727;222;-203;425;-1;
2025-08-07 14:36:40.226;222;-203;425;-1;
2025-08-07 14:36:40.726;225;-200;425;-1;
2025-08-07 14:36:41.226;225;-200;425;-1;
2025-08-07 14:36:41.727;224;-200;424;-1;
2025-08-07 14:36:42.227;224;-200;424;-1;
2025-08-07 14:36:42.726;224;-201;425;-1;
2025-08-07 14:36:43.226;224;-201;425;-1;
2025-08-07 14:36:43.726;223;-203;426;-1;
2025-08-07 14:36:44.227;223;-203;426;-1;
2025-08-07 14:36:44.727;251;-186;437;-1;
2025-08-07 14:36:45.226;251;-186;437;-1;
2025-08-07 14:36:45.727;328;-105;433;-1;
2025-08-07 14:36:46.226;328;-105;433;-1;
2025-08-07 14:36:46.726;404;-35;439;-1;
2025-08-07 14:36:47.226;404;-35;439;-1;
2025-08-07 14:36:47.727;396;-32;428;-1;
2025-08-07 14:36:48.226;396;-32;428;-1;
2025-08-07 14:36:48.727;398;-29;427;-1;
2025-08-07 14:36:49.226;398;-29;427;-1;
2025-08-07 14:36:49.726;399;-29;428;-1;
2025-08-07 14:36:50.226;399;-29;428;-1;
2025-08-07 14:36:50.726;399;-28;427;-1;
2025-08-07 14:36:51.226;399;-28;427;-1;
2025-08-07 14:36:51.727;397;-33;430;-1;
2025-08-07 14:36:52.226;397;-33;430;-1;
2025-08-07 14:36:52.726;398;-182;580;-1;
2025-08-07 14:36:53.226;398;-182;580;-1;
2025-08-07 14:36:53.727;399;-119;518;-1;
2025-08-07 14:36:54.226;399;-119;518;-1;
2025-08-07 14:36:54.907;398;-147;545;-1;
2025-08-07 14:36:55.260;398;-147;545;-1;
2025-08-07 14:36:55.904;399;-150;549;-1;
2025-08-07 14:36:56.226;399;-150;549;-1;
2025-08-07 14:36:56.787;431;-9;440;-1;
2025-08-07 14:36:57.449;431;-9;440;-1;
2025-08-07 14:36:57.728;474;37;437;-1;
2025-08-07 14:36:58.321;474;37;437;-1;
2025-08-07 14:36:58.958;485;51;434;-1;
2025-08-07 14:36:59.226;485;51;434;-1;
2025-08-07 14:36:59.726;488;57;431;-1;
2025-08-07 14:37:00.226;488;57;431;-1;
2025-08-07 14:37:00.726;489;-136;625;-1;
2025-08-07 14:37:01.226;489;-136;625;-1;
2025-08-07 14:37:01.726;487;-43;530;-1;
2025-08-07 14:37:02.226;487;-43;530;-1;
2025-08-07 14:37:02.726;488;-39;527;-1;
2025-08-07 14:37:03.226;488;-39;527;-1;
2025-08-07 14:37:03.726;490;-43;533;-1;
2025-08-07 14:37:04.226;490;-43;533;-1;
2025-08-07 14:37:04.726;489;67;422;-1;
2025-08-07 14:37:05.229;489;67;422;-1;
2025-08-07 14:37:05.726;489;64;425;-1;
2025-08-07 14:37:06.225;489;64;425;-1;
2025-08-07 14:37:06.725;490;61;429;-1;
2025-08-07 14:37:07.226;490;61;429;-1;
2025-08-07 14:37:07.726;489;66;423;-1;
2025-08-07 14:37:08.226;489;66;423;-1;
2025-08-07 14:37:08.725;492;62;430;-1;
2025-08-07 14:37:09.226;492;62;430;-1;
2025-08-07 14:37:09.726;489;-47;536;-1;
2025-08-07 14:37:10.225;489;-47;536;-1;
2025-08-07 14:37:10.726;489;-59;548;-1;
2025-08-07 14:37:11.225;489;-59;548;-1;
2025-08-07 14:37:11.726;489;-62;551;-1;
2025-08-07 14:37:12.225;489;-62;551;-1;
2025-08-07 14:37:12.726;490;-43;533;-1;
2025-08-07 14:37:13.225;490;-43;533;-1;
2025-08-07 14:37:13.726;488;-47;535;-1;
2025-08-07 14:37:14.226;488;-47;535;-1;
2025-08-07 14:37:14.726;490;-29;519;-1;
2025-08-07 14:37:15.225;490;-29;519;-1;
2025-08-07 14:37:15.726;493;0;493;-1;
2025-08-07 14:37:16.225;493;0;493;-1;
2025-08-07 14:37:16.726;490;3;487;-1;
2025-08-07 14:37:17.227;490;3;487;-1;
2025-08-07 14:37:17.726;488;6;482;-1;
2025-08-07 14:37:18.225;488;6;482;-1;
2025-08-07 14:37:18.725;488;6;482;-1;
2025-08-07 14:37:19.225;488;6;482;-1;
2025-08-07 14:37:19.725;487;23;464;-1;
2025-08-07 14:37:20.225;487;23;464;-1;
2025-08-07 14:37:20.726;487;13;474;-1;
2025-08-07 14:37:21.225;487;13;474;-1;
2025-08-07 14:37:21.726;493;8;485;-1;
2025-08-07 14:37:22.225;493;8;485;-1;
2025-08-07 14:37:22.726;488;15;473;-1;
2025-08-07 14:37:23.225;488;15;473;-1;
2025-08-07 14:37:23.726;488;-9;497;-1;
2025-08-07 14:37:24.225;488;-9;497;-1;
2025-08-07 14:37:24.725;487;-28;515;-1;
2025-08-07 14:37:25.225;487;-28;515;-1;
2025-08-07 14:37:25.726;491;31;460;-1;
2025-08-07 14:37:26.225;491;31;460;-1;
2025-08-07 14:37:26.725;486;31;455;-1;
2025-08-07 14:37:27.225;486;31;455;-1;
2025-08-07 14:37:27.726;493;-17;510;-1;
2025-08-07 14:37:28.225;493;-17;510;-1;
2025-08-07 14:37:28.726;491;0;491;-1;
2025-08-07 14:37:29.225;491;0;491;-1;
2025-08-07 14:37:29.726;489;29;460;-1;
2025-08-07 14:37:30.225;489;29;460;-1;
2025-08-07 14:37:30.725;489;26;463;-1;
2025-08-07 14:37:31.225;489;26;463;-1;
2025-08-07 14:37:31.726;489;11;478;-1;
2025-08-07 14:37:32.225;489;11;478;-1;
2025-08-07 14:37:32.726;487;21;466;-1;
2025-08-07 14:37:33.225;487;21;466;-1;
2025-08-07 14:37:33.725;490;29;461;-1;
2025-08-07 14:37:34.225;490;29;461;-1;
2025-08-07 14:37:34.725;488;0;488;-1;
2025-08-07 14:37:35.225;488;0;488;-1;
2025-08-07 14:37:35.725;492;27;465;-1;
2025-08-07 14:37:36.225;492;27;465;-1;
2025-08-07 14:37:36.725;490;24;466;-1;
2025-08-07 14:37:37.224;490;24;466;-1;
2025-08-07 14:37:37.726;490;30;460;-1;
2025-08-07 14:37:38.224;490;30;460;-1;
2025-08-07 14:37:38.725;490;28;462;-1;
2025-08-07 14:37:39.224;490;28;462;-1;
2025-08-07 14:37:39.725;488;25;463;-1;
2025-08-07 14:37:40.224;488;25;463;-1;
2025-08-07 14:37:40.725;489;14;475;-1;
2025-08-07 14:37:41.224;489;14;475;-1;
2025-08-07 14:37:41.725;487;-136;623;-1;
2025-08-07 14:37:42.225;487;-136;623;-1;
2025-08-07 14:37:42.725;489;-180;669;-1;
2025-08-07 14:37:43.224;489;-180;669;-1;
2025-08-07 14:37:43.725;490;-256;746;-1;
2025-08-07 14:37:44.225;490;-256;746;-1;
2025-08-07 14:37:44.724;487;-305;792;-1;
2025-08-07 14:37:45.224;487;-305;792;-1;
2025-08-07 14:37:45.724;489;-350;839;-1;
2025-08-07 14:37:46.224;489;-350;839;-1;
2025-08-07 14:37:46.725;489;27;462;-1;
2025-08-07 14:37:47.224;489;27;462;-1;
2025-08-07 14:37:47.725;489;48;441;-1;
2025-08-07 14:37:48.224;489;48;441;-1;
2025-08-07 14:37:48.724;489;55;434;-1;
2025-08-07 14:37:49.237;489;55;434;-1;
2025-08-07 14:37:49.724;488;29;459;-1;
2025-08-07 14:37:50.223;488;29;459;-1;
2025-08-07 14:37:50.725;492;35;457;-1;
2025-08-07 14:37:51.194;9;write_maxpower_HTTP. Ecriture HTTP de maxpower = 132W pour 3 devices
2025-08-07 14:37:51.243;492;35;457;-1;
2025-08-07 14:37:51.725;491;41;450;-1;
2025-08-07 14:37:52.224;491;41;450;-1;
2025-08-07 14:37:52.724;491;58;433;-1;
2025-08-07 14:37:53.224;491;58;433;-1;
2025-08-07 14:37:53.725;489;41;448;-1;
2025-08-07 14:37:54.224;489;41;448;-1;
2025-08-07 14:37:54.724;488;52;436;-1;
2025-08-07 14:37:55.223;488;52;436;-1;
2025-08-07 14:37:55.725;490;46;444;-1;
2025-08-07 14:37:56.225;490;46;444;-1;
2025-08-07 14:37:56.296;9;write_maxpower_HTTP. Fin d'exécution de la procédure
2025-08-07 14:37:56.724;491;44;447;-1;
2025-08-07 14:37:57.223;491;44;447;-1;
2025-08-07 14:37:57.725;492;47;445;-1;
2025-08-07 14:37:58.223;492;47;445;-1;
2025-08-07 14:37:58.725;493;50;443;-1;
2025-08-07 14:37:59.223;493;50;443;-1;
2025-08-07 14:37:59.725;491;56;435;-1;
2025-08-07 14:38:00.223;491;56;435;-1;
2025-08-07 14:38:00.725;532;97;435;-1;
2025-08-07 14:38:01.224;532;97;435;-1;
2025-08-07 14:38:01.724;641;188;453;-1;
2025-08-07 14:38:02.223;641;188;453;-1;
2025-08-07 14:38:02.724;647;177;470;-1;
2025-08-07 14:38:03.412;647;177;470;-1;
2025-08-07 14:38:03.766;646;176;470;-1;
2025-08-07 14:38:04.410;646;176;470;-1;
2025-08-07 14:38:04.724;647;175;472;-1;
2025-08-07 14:38:05.293;647;175;472;-1;
2025-08-07 14:38:05.951;647;162;485;-1;
2025-08-07 14:38:06.224;647;162;485;-1;
2025-08-07 14:38:06.828;648;184;464;-1;
2025-08-07 14:38:07.224;648;184;464;-1;
2025-08-07 14:38:07.732;646;182;464;-1;
2025-08-07 14:38:08.223;646;182;464;-1;
2025-08-07 14:38:08.723;652;190;462;-1;
2025-08-07 14:38:09.223;652;190;462;-1;
2025-08-07 14:38:09.724;648;207;441;-1;
2025-08-07 14:38:10.223;648;207;441;-1;
2025-08-07 14:38:10.723;647;200;447;-1;
2025-08-07 14:38:11.223;647;200;447;-1;
2025-08-07 14:38:11.724;655;228;427;-1;
2025-08-07 14:38:12.223;655;228;427;-1;
2025-08-07 14:38:12.724;742;299;443;-1;
2025-08-07 14:38:13.223;742;299;443;-1;
2025-08-07 14:38:13.723;719;291;428;-1;
2025-08-07 14:38:14.223;719;291;428;-1;
2025-08-07 14:38:14.724;729;272;457;-1;
2025-08-07 14:38:15.223;729;272;457;-1;
2025-08-07 14:38:15.724;729;293;436;-1;
2025-08-07 14:38:16.223;729;293;436;-1;
2025-08-07 14:38:16.723;731;301;430;-1;
2025-08-07 14:38:17.223;731;301;430;-1;
2025-08-07 14:38:17.723;733;302;431;-1;
2025-08-07 14:38:18.223;733;302;431;-1;
2025-08-07 14:38:18.723;728;302;426;-1;
2025-08-07 14:38:19.223;728;302;426;-1;
2025-08-07 14:38:19.723;728;299;429;-1;
2025-08-07 14:38:20.223;728;299;429;-1;
2025-08-07 14:38:20.723;732;303;429;-1;
2025-08-07 14:38:21.223;732;303;429;-1;
2025-08-07 14:38:21.723;729;302;427;-1;
2025-08-07 14:38:22.223;729;302;427;-1;
2025-08-07 14:38:22.723;728;299;429;-1;
2025-08-07 14:38:23.223;728;299;429;-1;
2025-08-07 14:38:23.723;728;292;436;-1;
2025-08-07 14:38:24.224;728;292;436;-1;
2025-08-07 14:38:24.724;730;171;559;-1;
2025-08-07 14:38:25.223;730;171;559;-1;
2025-08-07 14:38:25.724;734;228;506;-1;
2025-08-07 14:38:26.223;734;228;506;-1;
2025-08-07 14:38:26.723;730;189;541;-1;
2025-08-07 14:38:27.223;730;189;541;-1;
2025-08-07 14:38:27.723;728;292;436;-1;
2025-08-07 14:38:28.222;728;292;436;-1;
2025-08-07 14:38:28.722;731;297;434;-1;
2025-08-07 14:38:29.223;731;297;434;-1;
2025-08-07 14:38:29.723;729;297;432;-1;
2025-08-07 14:38:30.223;729;297;432;-1;
2025-08-07 14:38:30.722;727;286;441;-1;
2025-08-07 14:38:31.222;727;286;441;-1;
2025-08-07 14:38:31.723;731;296;435;-1;
2025-08-07 14:38:32.223;731;296;435;-1;
2025-08-07 14:38:32.723;731;225;506;-1;
2025-08-07 14:38:33.222;731;225;506;-1;
2025-08-07 14:38:33.723;729;217;512;-1;
2025-08-07 14:38:34.222;729;217;512;-1;
2025-08-07 14:38:34.723;728;222;506;-1;
2025-08-07 14:38:35.222;728;222;506;-1;
2025-08-07 14:38:35.723;730;299;431;-1;
2025-08-07 14:38:36.222;730;299;431;-1;
2025-08-07 14:38:36.722;729;302;427;-1;
2025-08-07 14:38:37.222;729;302;427;-1;
2025-08-07 14:38:37.723;729;304;425;-1;
2025-08-07 14:38:38.222;729;304;425;-1;
2025-08-07 14:38:38.722;729;301;428;-1;
2025-08-07 14:38:39.223;729;301;428;-1;
2025-08-07 14:38:39.722;728;302;426;-1;
2025-08-07 14:38:40.222;728;302;426;-1;
2025-08-07 14:38:40.723;731;280;451;-1;
2025-08-07 14:38:41.222;731;280;451;-1;
2025-08-07 14:38:41.723;728;197;531;-1;
2025-08-07 14:38:42.222;728;197;531;-1;
2025-08-07 14:38:42.722;728;196;532;-1;
2025-08-07 14:38:43.223;728;196;532;-1;
2025-08-07 14:38:43.723;729;208;521;-1;
2025-08-07 14:38:44.222;729;208;521;-1;
2025-08-07 14:38:44.722;730;207;523;-1;
2025-08-07 14:38:45.222;730;207;523;-1;
2025-08-07 14:38:45.722;730;218;512;-1;
2025-08-07 14:38:46.222;730;218;512;-1;
2025-08-07 14:38:46.722;730;252;478;-1;
2025-08-07 14:38:47.222;730;252;478;-1;
2025-08-07 14:38:47.722;731;247;484;-1;
2025-08-07 14:38:48.222;731;247;484;-1;
2025-08-07 14:38:48.722;732;243;489;-1;
2025-08-07 14:38:49.222;732;243;489;-1;
2025-08-07 14:38:49.722;731;262;469;-1;
2025-08-07 14:38:50.222;731;262;469;-1;
2025-08-07 14:38:50.722;730;270;460;-1;
2025-08-07 14:38:51.222;730;270;460;-1;
2025-08-07 14:38:51.722;729;263;466;-1;
2025-08-07 14:38:52.221;729;263;466;-1;
2025-08-07 14:38:52.722;737;262;475;-1;
2025-08-07 14:38:53.222;737;262;475;-1;
2025-08-07 14:38:53.722;732;256;476;-1;
2025-08-07 14:38:54.222;732;256;476;-1;
2025-08-07 14:38:54.723;736;278;458;-1;
2025-08-07 14:38:55.221;736;278;458;-1;
2025-08-07 14:38:55.722;737;209;528;-1;
2025-08-07 14:38:56.222;737;209;528;-1;
2025-08-07 14:38:56.722;734;282;452;-1;
2025-08-07 14:38:57.221;734;282;452;-1;
2025-08-07 14:38:57.722;735;293;442;-1;
2025-08-07 14:38:58.222;735;293;442;-1;
2025-08-07 14:38:58.721;736;273;463;-1;
2025-08-07 14:38:59.221;736;273;463;-1;
2025-08-07 14:38:59.722;733;258;475;-1;
2025-08-07 14:39:00.221;733;258;475;-1;
2025-08-07 14:39:00.723;733;271;462;-1;
2025-08-07 14:39:01.221;733;271;462;-1;
2025-08-07 14:39:01.721;735;263;472;-1;
2025-08-07 14:39:02.221;735;263;472;-1;
2025-08-07 14:39:02.721;735;269;466;-1;
2025-08-07 14:39:03.222;735;269;466;-1;
2025-08-07 14:39:03.723;732;275;457;-1;
2025-08-07 14:39:04.222;732;275;457;-1;
2025-08-07 14:39:04.721;734;274;460;-1;
2025-08-07 14:39:05.221;734;274;460;-1;
2025-08-07 14:39:05.721;734;275;459;-1;
2025-08-07 14:39:06.221;734;275;459;-1;
2025-08-07 14:39:06.722;731;268;463;-1;
2025-08-07 14:39:07.221;731;268;463;-1;
2025-08-07 14:39:07.722;735;270;465;-1;
2025-08-07 14:39:08.221;735;270;465;-1;
2025-08-07 14:39:08.721;737;276;461;-1;
2025-08-07 14:39:09.221;737;276;461;-1;
2025-08-07 14:39:09.721;735;279;456;-1;
2025-08-07 14:39:10.221;735;279;456;-1;
2025-08-07 14:39:10.721;734;275;459;-1;
2025-08-07 14:39:11.221;734;275;459;-1;
2025-08-07 14:39:11.721;736;278;458;-1;
2025-08-07 14:39:12.221;736;278;458;-1;
2025-08-07 14:39:12.721;735;273;462;-1;
2025-08-07 14:39:13.221;735;273;462;-1;
2025-08-07 14:39:13.722;734;23;711;-1;
2025-08-07 14:39:14.221;734;23;711;-1;
2025-08-07 14:39:14.722;732;-5;737;-1;
2025-08-07 14:39:15.221;732;-5;737;-1;
2025-08-07 14:39:15.721;735;-65;800;-1;
2025-08-07 14:39:16.220;735;-65;800;-1;
2025-08-07 14:39:16.721;732;225;507;-1;
2025-08-07 14:39:17.221;732;225;507;-1;
2025-08-07 14:39:17.721;733;230;503;-1;
2025-08-07 14:39:18.226;733;230;503;-1;
2025-08-07 14:39:18.721;732;120;612;-1;
2025-08-07 14:39:19.221;732;120;612;-1;
2025-08-07 14:39:19.721;731;166;565;-1;
2025-08-07 14:39:20.221;731;166;565;-1;
2025-08-07 14:39:20.721;735;190;545;-1;
2025-08-07 14:39:21.220;735;190;545;-1;
2025-08-07 14:39:21.721;733;144;589;-1;
2025-08-07 14:39:22.220;733;144;589;-1;
2025-08-07 14:39:22.721;735;162;573;-1;
2025-08-07 14:39:23.220;735;162;573;-1;
2025-08-07 14:39:23.722;733;148;585;-1;
2025-08-07 14:39:24.220;733;148;585;-1;
2025-08-07 14:39:24.728;731;151;580;-1;
2025-08-07 14:39:25.220;731;151;580;-1;
2025-08-07 14:39:25.722;734;131;603;-1;
2025-08-07 14:39:26.220;734;131;603;-1;
2025-08-07 14:39:26.721;736;134;602;-1;
2025-08-07 14:39:27.220;736;134;602;-1;
2025-08-07 14:39:27.339;9;write_maxpower_HTTP. Ecriture HTTP de maxpower = 88W pour 3 devices
2025-08-07 14:39:27.721;733;124;609;-1;
2025-08-07 14:39:28.220;733;124;609;-1;
2025-08-07 14:39:28.720;735;140;595;-1;
2025-08-07 14:39:29.221;735;140;595;-1;
2025-08-07 14:39:29.722;734;137;597;-1;
2025-08-07 14:39:30.220;734;137;597;-1;
2025-08-07 14:39:30.720;735;192;543;-1;
2025-08-07 14:39:31.220;735;192;543;-1;
2025-08-07 14:39:31.916;734;226;508;-1;
2025-08-07 14:39:32.220;734;226;508;-1;
2025-08-07 14:39:32.550;9;write_maxpower_HTTP. Fin d'exécution de la procédure
2025-08-07 14:39:32.862;733;212;521;-1;
2025-08-07 14:39:33.221;733;212;521;-1;
2025-08-07 14:39:33.720;733;186;547;-1;
2025-08-07 14:39:34.423;733;186;547;-1;
2025-08-07 14:39:34.720;732;161;571;-1;
2025-08-07 14:39:35.300;732;161;571;-1;
2025-08-07 14:39:35.915;734;215;519;-1;
2025-08-07 14:39:36.222;734;215;519;-1;
2025-08-07 14:39:36.721;735;212;523;-1;
2025-08-07 14:39:37.220;735;212;523;-1;
2025-08-07 14:39:37.721;728;195;533;-1;
2025-08-07 14:39:38.220;728;195;533;-1;
2025-08-07 14:39:38.720;652;119;533;-1;
2025-08-07 14:39:39.220;652;119;533;-1;
2025-08-07 14:39:39.720;571;41;530;-1;
2025-08-07 14:39:40.220;571;41;530;-1;
2025-08-07 14:39:40.721;515;-7;522;-1;
2025-08-07 14:39:41.220;515;-7;522;-1;
2025-08-07 14:39:41.720;499;-34;533;-1;
2025-08-07 14:39:42.220;499;-34;533;-1;
2025-08-07 14:39:42.720;495;-54;549;-1;
2025-08-07 14:39:43.220;495;-54;549;-1;
2025-08-07 14:39:43.723;496;-74;570;-1;
2025-08-07 14:39:44.220;496;-74;570;-1;
2025-08-07 14:39:44.720;492;-64;556;-1;
2025-08-07 14:39:45.219;492;-64;556;-1;
2025-08-07 14:39:45.720;495;-71;566;-1;
2025-08-07 14:39:46.219;495;-71;566;-1;
2025-08-07 14:39:46.720;496;-57;553;-1;
2025-08-07 14:39:47.219;496;-57;553;-1;
2025-08-07 14:39:47.720;495;-61;556;-1;
2025-08-07 14:39:48.219;495;-61;556;-1;
2025-08-07 14:39:48.720;496;-79;575;-1;
2025-08-07 14:39:49.219;496;-79;575;-1;
2025-08-07 14:39:49.720;496;-38;534;-1;
2025-08-07 14:39:50.219;496;-38;534;-1;
2025-08-07 14:39:50.719;495;-35;530;-1;
2025-08-07 14:39:51.219;495;-35;530;-1;
2025-08-07 14:39:51.720;496;-57;553;-1;
2025-08-07 14:39:52.219;496;-57;553;-1;
2025-08-07 14:39:52.721;493;-36;529;-1;
2025-08-07 14:39:53.219;493;-36;529;-1;
2025-08-07 14:39:53.720;495;-37;532;-1;
2025-08-07 14:39:54.224;495;-37;532;-1;
2025-08-07 14:39:54.725;498;-38;536;-1;
2025-08-07 14:39:55.220;498;-38;536;-1;
2025-08-07 14:39:55.719;494;-40;534;-1;
2025-08-07 14:39:56.223;494;-40;534;-1;
2025-08-07 14:39:56.720;494;-48;542;-1;
2025-08-07 14:39:57.219;494;-48;542;-1;
2025-08-07 14:39:57.720;495;-67;562;-1;
2025-08-07 14:39:58.219;495;-67;562;-1;
2025-08-07 14:39:58.720;492;-64;556;-1;
2025-08-07 14:39:59.219;492;-64;556;-1;
2025-08-07 14:39:59.719;496;-90;586;-1;
2025-08-07 14:40:00.219;496;-90;586;-1;
2025-08-07 14:40:00.720;493;-79;572;-1;
2025-08-07 14:40:01.219;493;-79;572;-1;
2025-08-07 14:40:01.574;9;write_maxpower_HTTP. Ecriture HTTP de maxpower = 66W pour 3 devices
2025-08-07 14:40:01.720;493;-69;562;-1;
2025-08-07 14:40:02.219;493;-69;562;-1;
2025-08-07 14:40:02.720;493;-48;541;-1;
2025-08-07 14:40:03.219;493;-48;541;-1;
2025-08-07 14:40:03.721;496;-35;531;-1;
2025-08-07 14:40:04.219;496;-35;531;-1;
2025-08-07 14:40:04.720;495;-37;532;-1;
2025-08-07 14:40:05.219;495;-37;532;-1;
2025-08-07 14:40:05.720;494;-52;546;-1;
2025-08-07 14:40:06.219;494;-52;546;-1;
2025-08-07 14:40:06.646;9;write_maxpower_HTTP. Fin d'exécution de la procédure
2025-08-07 14:40:06.719;492;-43;535;-1;
2025-08-07 14:40:07.219;492;-43;535;-1;
2025-08-07 14:40:07.719;496;-35;531;-1;
2025-08-07 14:40:08.219;496;-35;531;-1;
2025-08-07 14:40:08.719;495;-35;530;-1;
2025-08-07 14:40:09.219;495;-35;530;-1;
2025-08-07 14:40:09.719;496;-34;530;-1;
2025-08-07 14:40:10.219;496;-34;530;-1;
2025-08-07 14:40:10.719;493;-31;524;-1;
2025-08-07 14:40:11.219;493;-31;524;-1;
2025-08-07 14:40:11.719;494;-27;521;-1;
2025-08-07 14:40:12.219;494;-27;521;-1;
2025-08-07 14:40:12.719;494;-35;529;-1;
2025-08-07 14:40:13.218;494;-35;529;-1;
2025-08-07 14:40:13.728;495;-33;528;-1;
2025-08-07 14:40:14.218;495;-33;528;-1;
2025-08-07 14:40:14.719;497;-26;523;-1;
2025-08-07 14:40:15.219;497;-26;523;-1;
2025-08-07 14:40:15.719;495;-12;507;-1;
2025-08-07 14:40:16.219;495;-12;507;-1;
2025-08-07 14:40:16.719;494;-45;539;-1;
2025-08-07 14:40:17.218;494;-45;539;-1;
2025-08-07 14:40:17.719;490;-46;536;-1;
2025-08-07 14:40:18.218;490;-46;536;-1;
2025-08-07 14:40:18.718;458;-72;530;-1;
2025-08-07 14:40:19.218;458;-72;530;-1;
2025-08-07 14:40:19.718;370;-162;532;-1;
2025-08-07 14:40:20.219;370;-162;532;-1;
2025-08-07 14:40:20.718;373;-158;531;-1;
2025-08-07 14:40:21.218;373;-158;531;-1;
2025-08-07 14:40:21.718;371;-166;537;-1;
2025-08-07 14:40:22.218;371;-166;537;-1;
2025-08-07 14:40:22.718;374;-159;533;-1;
2025-08-07 14:40:23.218;374;-159;533;-1;
2025-08-07 14:40:23.718;373;-163;536;-1;
2025-08-07 14:40:24.218;373;-163;536;-1;
2025-08-07 14:40:24.719;369;-168;537;-1;
2025-08-07 14:40:25.218;369;-168;537;-1;
2025-08-07 14:40:25.718;371;-167;538;-1;
2025-08-07 14:40:26.218;371;-167;538;-1;
2025-08-07 14:40:26.718;371;-166;537;-1;
2025-08-07 14:40:27.218;371;-166;537;-1;
2025-08-07 14:40:27.718;372;-162;534;-1;
2025-08-07 14:40:28.218;372;-162;534;-1;
2025-08-07 14:40:28.718;372;-162;534;-1;
2025-08-07 14:40:29.218;372;-162;534;-1;
2025-08-07 14:40:29.718;369;-161;530;-1;
2025-08-07 14:40:30.218;369;-161;530;-1;
2025-08-07 14:40:30.718;369;-163;532;-1;
2025-08-07 14:40:31.218;369;-163;532;-1;
2025-08-07 14:40:31.718;370;-167;537;-1;
2025-08-07 14:40:32.218;370;-167;537;-1;
2025-08-07 14:40:32.718;371;-162;533;-1;
2025-08-07 14:40:33.218;371;-162;533;-1;
2025-08-07 14:40:33.718;374;-177;551;-1;
2025-08-07 14:40:34.218;374;-177;551;-1;
2025-08-07 14:40:34.718;368;-182;550;-1;
2025-08-07 14:40:35.218;368;-182;550;-1;
2025-08-07 14:40:35.718;371;-166;537;-1;
2025-08-07 14:40:36.218;371;-166;537;-1;
2025-08-07 14:40:36.718;369;-179;548;-1;
2025-08-07 14:40:37.218;369;-179;548;-1;
2025-08-07 14:40:37.718;373;-165;538;-1;
2025-08-07 14:40:38.218;373;-165;538;-1;
2025-08-07 14:40:38.717;370;-171;541;-1;
2025-08-07 14:40:39.218;370;-171;541;-1;
2025-08-07 14:40:39.717;368;-167;535;-1;
2025-08-07 14:40:40.218;368;-167;535;-1;
2025-08-07 14:40:40.717;371;-161;532;-1;
2025-08-07 14:40:41.352;371;-161;532;-1;
2025-08-07 14:40:41.733;370;-179;549;-1;
2025-08-07 14:40:42.217;370;-179;549;-1;
2025-08-07 14:40:42.909;371;-177;548;-1;
2025-08-07 14:40:43.239;371;-177;548;-1;
2025-08-07 14:40:43.531;9;write_maxpower_HTTP. Ecriture HTTP de maxpower = 44W pour 3 devices
2025-08-07 14:40:43.717;371;-185;556;-1;
2025-08-07 14:40:44.419;371;-185;556;-1;
2025-08-07 14:40:44.749;371;-161;532;-1;
2025-08-07 14:40:45.217;371;-161;532;-1;
2025-08-07 14:40:45.717;372;-159;531;-1;
2025-08-07 14:40:46.217;372;-159;531;-1;
2025-08-07 14:40:46.718;370;-162;532;-1;
2025-08-07 14:40:47.217;370;-162;532;-1;
2025-08-07 14:40:47.718;369;-166;535;-1;
2025-08-07 14:40:48.217;369;-166;535;-1;
2025-08-07 14:40:48.717;370;-164;534;-1;
2025-08-07 14:40:48.809;9;write_maxpower_HTTP. Fin d'exécution de la procédure
2025-08-07 14:40:49.218;370;-164;534;-1;
2025-08-07 14:40:49.717;372;-157;529;-1;
2025-08-07 14:40:50.217;372;-157;529;-1;
2025-08-07 14:40:50.717;370;-186;556;-1;
2025-08-07 14:40:51.218;370;-186;556;-1;
2025-08-07 14:40:51.717;369;-161;530;-1;
2025-08-07 14:40:52.218;369;-161;530;-1;
2025-08-07 14:40:52.717;369;-163;532;-1;
2025-08-07 14:40:53.218;369;-163;532;-1;
2025-08-07 14:40:53.718;368;-199;567;-1;
2025-08-07 14:40:54.217;368;-199;567;-1;
2025-08-07 14:40:54.717;367;-163;530;-1;
2025-08-07 14:40:55.217;367;-163;530;-1;
2025-08-07 14:40:55.717;369;-161;530;-1;
2025-08-07 14:40:56.217;369;-161;530;-1;
2025-08-07 14:40:56.717;370;-171;541;-1;
2025-08-07 14:40:57.217;370;-171;541;-1;
2025-08-07 14:40:57.718;369;-180;549;-1;
2025-08-07 14:40:58.217;369;-180;549;-1;
2025-08-07 14:40:58.719;357;-207;564;-1;
2025-08-07 14:40:59.217;357;-207;564;-1;
2025-08-07 14:40:59.717;296;-261;557;-1;
2025-08-07 14:41:00.217;296;-261;557;-1;
2025-08-07 14:41:00.717;263;-300;563;-1;
2025-08-07 14:41:01.217;263;-300;563;-1;
2025-08-07 14:41:01.717;254;-298;552;-1;
2025-08-07 14:41:02.217;254;-298;552;-1;
2025-08-07 14:41:02.717;247;-291;538;-1;
2025-08-07 14:41:03.217;247;-291;538;-1;
2025-08-07 14:41:03.718;244;-290;534;-1;
2025-08-07 14:41:04.216;244;-290;534;-1;
2025-08-07 14:41:04.717;244;-292;536;-1;
2025-08-07 14:41:05.217;244;-292;536;-1;
2025-08-07 14:41:05.716;245;-292;537;-1;
2025-08-07 14:41:06.216;245;-292;537;-1;
2025-08-07 14:41:06.716;247;-295;542;-1;
2025-08-07 14:41:07.216;247;-295;542;-1;
2025-08-07 14:41:07.717;246;-288;534;-1;
2025-08-07 14:41:08.217;246;-288;534;-1;
2025-08-07 14:41:08.717;245;-292;537;-1;
2025-08-07 14:41:09.216;245;-292;537;-1;
2025-08-07 14:41:09.717;244;-285;529;-1;
2025-08-07 14:41:10.218;244;-285;529;-1;
2025-08-07 14:41:10.716;245;-289;534;-1;
2025-08-07 14:41:11.216;245;-289;534;-1;
2025-08-07 14:41:11.716;244;-298;542;-1;
2025-08-07 14:41:12.217;244;-298;542;-1;
2025-08-07 14:41:12.717;243;-297;540;-1;
2025-08-07 14:41:13.217;243;-297;540;-1;
2025-08-07 14:41:13.722;244;-300;544;-1;
2025-08-07 14:41:14.216;244;-300;544;-1;
2025-08-07 14:41:14.722;240;-300;540;-1;
2025-08-07 14:41:15.217;240;-300;540;-1;
2025-08-07 14:41:15.720;246;-288;534;-1;
2025-08-07 14:41:16.218;246;-288;534;-1;
2025-08-07 14:41:16.720;247;-288;535;-1;
2025-08-07 14:41:17.216;247;-288;535;-1;
2025-08-07 14:41:17.719;247;-289;536;-1;
2025-08-07 14:41:18.216;247;-289;536;-1;
2025-08-07 14:41:18.717;242;-290;532;-1;
2025-08-07 14:41:19.216;242;-290;532;-1;
2025-08-07 14:41:19.716;245;-287;532;-1;
2025-08-07 14:41:20.216;245;-287;532;-1;
2025-08-07 14:41:20.719;243;-298;541;-1;
2025-08-07 14:41:21.217;243;-298;541;-1;
2025-08-07 14:41:21.718;248;-281;529;-1;
2025-08-07 14:41:22.216;248;-281;529;-1;
2025-08-07 14:41:22.716;244;-288;532;-1;
2025-08-07 14:41:23.216;244;-288;532;-1;
2025-08-07 14:41:23.717;245;-287;532;-1;
2025-08-07 14:41:24.216;245;-287;532;-1;
2025-08-07 14:41:24.716;246;-284;530;-1;
2025-08-07 14:41:25.216;246;-284;530;-1;
2025-08-07 14:41:25.719;244;-285;529;-1;
2025-08-07 14:41:26.215;244;-285;529;-1;
2025-08-07 14:41:26.717;245;-302;547;-1;
2025-08-07 14:41:27.223;245;-302;547;-1;
2025-08-07 14:41:27.716;246;-300;546;-1;
2025-08-07 14:41:27.948;9;write_maxpower_HTTP. Ecriture HTTP de maxpower = 66W pour 3 devices
2025-08-07 14:41:28.216;246;-300;546;-1;
2025-08-07 14:41:28.718;244;-297;541;-1;
2025-08-07 14:41:29.216;244;-297;541;-1;
2025-08-07 14:41:29.718;244;-280;524;-1;
2025-08-07 14:41:30.216;244;-280;524;-1;
2025-08-07 14:41:30.716;244;-319;563;-1;
2025-08-07 14:41:31.215;244;-319;563;-1;
2025-08-07 14:41:31.716;245;-304;549;-1;
2025-08-07 14:41:32.216;245;-304;549;-1;
2025-08-07 14:41:32.717;243;-307;550;-1;
2025-08-07 14:41:33.205;9;write_maxpower_HTTP. Fin d'exécution de la procédure
2025-08-07 14:41:33.250;243;-307;550;-1;
2025-08-07 14:41:33.716;245;-283;528;-1;
2025-08-07 14:41:34.215;245;-283;528;-1;
2025-08-07 14:41:34.716;246;-295;541;-1;
2025-08-07 14:41:35.215;246;-295;541;-1;
2025-08-07 14:41:35.716;243;-281;524;-1;
2025-08-07 14:41:36.215;243;-281;524;-1;
2025-08-07 14:41:36.737;246;-285;531;-1;
2025-08-07 14:41:37.215;246;-285;531;-1;
2025-08-07 14:41:37.716;244;-284;528;-1;
2025-08-07 14:41:38.215;244;-284;528;-1;
2025-08-07 14:41:38.716;246;-281;527;-1;
2025-08-07 14:41:39.215;246;-281;527;-1;
2025-08-07 14:41:39.716;363;-165;528;-1;
2025-08-07 14:41:40.216;363;-165;528;-1;
2025-08-07 14:41:40.715;363;-162;525;-1;
2025-08-07 14:41:41.215;363;-162;525;-1;
2025-08-07 14:41:41.716;363;-169;532;-1;
2025-08-07 14:41:42.215;363;-169;532;-1;
2025-08-07 14:41:42.716;365;-161;526;-1;
2025-08-07 14:41:43.215;365;-161;526;-1;
2025-08-07 14:41:43.715;362;-167;529;-1;
2025-08-07 14:41:44.216;362;-167;529;-1;
2025-08-07 14:41:44.715;361;-171;532;-1;
2025-08-07 14:41:45.215;361;-171;532;-1;
2025-08-07 14:41:45.715;362;-167;529;-1;
2025-08-07 14:41:46.215;362;-167;529;-1;
2025-08-07 14:41:46.716;363;-166;529;-1;
2025-08-07 14:41:47.215;363;-166;529;-1;
2025-08-07 14:41:47.715;363;-174;537;-1;
2025-08-07 14:41:48.215;363;-174;537;-1;
2025-08-07 14:41:48.715;363;-169;532;-1;
2025-08-07 14:41:49.216;363;-169;532;-1;
2025-08-07 14:41:49.857;364;-175;539;-1;
2025-08-07 14:41:50.216;364;-175;539;-1;
2025-08-07 14:41:50.716;362;-164;526;-1;
2025-08-07 14:41:51.413;362;-164;526;-1;
2025-08-07 14:41:51.743;363;-162;525;-1;
2025-08-07 14:41:52.215;363;-162;525;-1;
2025-08-07 14:41:52.927;365;-92;457;-1;
2025-08-07 14:41:53.257;365;-92;457;-1;
2025-08-07 14:41:53.715;361;-64;425;-1;
2025-08-07 14:41:54.215;361;-64;425;-1;
2025-08-07 14:41:54.716;360;-66;426;-1;
2025-08-07 14:41:55.215;360;-66;426;-1;
2025-08-07 14:41:55.715;363;-68;431;-1;
2025-08-07 14:41:56.215;363;-68;431;-1;
2025-08-07 14:41:56.715;362;-99;461;-1;
2025-08-07 14:41:57.215;362;-99;461;-1;
2025-08-07 14:41:57.715;363;-80;443;-1;
2025-08-07 14:41:58.215;363;-80;443;-1;
2025-08-07 14:41:58.715;362;-66;428;-1;
2025-08-07 14:41:59.214;362;-66;428;-1;
2025-08-07 14:41:59.715;363;-71;434;-1;
2025-08-07 14:42:00.215;363;-71;434;-1;
2025-08-07 14:42:00.715;363;-63;426;-1;
2025-08-07 14:42:01.215;363;-63;426;-1;
2025-08-07 14:42:01.714;364;-61;425;-1;
2025-08-07 14:42:02.214;364;-61;425;-1;
2025-08-07 14:42:02.714;362;-63;425;-1;
2025-08-07 14:42:03.214;362;-63;425;-1;
2025-08-07 14:42:03.715;362;-63;425;-1;
2025-08-07 14:42:04.214;362;-63;425;-1;
2025-08-07 14:42:04.714;364;-64;428;-1;
2025-08-07 14:42:05.214;364;-64;428;-1;
2025-08-07 14:42:05.714;362;-56;418;-1;
2025-08-07 14:42:06.214;362;-56;418;-1;
2025-08-07 14:42:06.714;362;-60;422;-1;
2025-08-07 14:42:07.214;362;-60;422;-1;
2025-08-07 14:42:07.714;360;-67;427;-1;
2025-08-07 14:42:08.214;360;-67;427;-1;
2025-08-07 14:42:08.715;360;-75;435;-1;
2025-08-07 14:42:09.214;360;-75;435;-1;
2025-08-07 14:42:09.714;363;-15;378;-1;
2025-08-07 14:42:10.214;363;-15;378;-1;
2025-08-07 14:42:10.714;363;34;329;-1;
2025-08-07 14:42:11.214;363;34;329;-1;
2025-08-07 14:42:11.714;364;36;328;-1;
2025-08-07 14:42:12.214;364;36;328;-1;
2025-08-07 14:42:12.714;361;32;329;-1;
2025-08-07 14:42:13.214;361;32;329;-1;
2025-08-07 14:42:13.714;363;42;321;-1;
2025-08-07 14:42:14.233;363;42;321;-1;
2025-08-07 14:42:14.714;361;20;341;-1;
2025-08-07 14:42:15.214;361;20;341;-1;
2025-08-07 14:42:15.714;362;27;335;-1;
2025-08-07 14:42:16.214;362;27;335;-1;
2025-08-07 14:42:16.714;364;31;333;-1;
2025-08-07 14:42:16.760;9;write_maxpower_HTTP. Ecriture HTTP de maxpower = 88W pour 3 devices
2025-08-07 14:42:17.214;364;31;333;-1;
2025-08-07 14:42:17.714;364;46;318;-1;
2025-08-07 14:42:18.214;364;46;318;-1;
2025-08-07 14:42:18.714;361;50;311;-1;
2025-08-07 14:42:19.214;361;50;311;-1;
2025-08-07 14:42:19.714;364;53;311;-1;
2025-08-07 14:42:20.214;364;53;311;-1;
2025-08-07 14:42:20.714;362;52;310;-1;
2025-08-07 14:42:21.214;362;52;310;-1;
2025-08-07 14:42:21.715;364;56;308;-1;
2025-08-07 14:42:22.214;364;56;308;-1;
2025-08-07 14:42:22.498;9;write_maxpower_HTTP. Fin d'exécution de la procédure
2025-08-07 14:42:22.714;362;43;319;-1;
2025-08-07 14:42:23.214;362;43;319;-1;
2025-08-07 14:42:23.714;361;52;309;-1;
2025-08-07 14:42:24.214;361;52;309;-1;
2025-08-07 14:42:24.714;363;45;318;-1;
2025-08-07 14:42:25.214;363;45;318;-1;
2025-08-07 14:42:25.714;359;40;319;-1;
2025-08-07 14:42:26.214;359;40;319;-1;
2025-08-07 14:42:26.714;370;47;323;-1;
2025-08-07 14:42:27.214;370;47;323;-1;
2025-08-07 14:42:27.714;419;99;320;-1;
2025-08-07 14:42:28.213;419;99;320;-1;
2025-08-07 14:42:28.714;442;120;322;-1;
2025-08-07 14:42:29.214;442;120;322;-1;
2025-08-07 14:42:29.713;442;122;320;-1;
2025-08-07 14:42:30.213;442;122;320;-1;
2025-08-07 14:42:30.715;442;124;318;-1;
2025-08-07 14:42:31.213;442;124;318;-1;
2025-08-07 14:42:31.714;441;120;321;-1;
2025-08-07 14:42:32.214;441;120;321;-1;
2025-08-07 14:42:32.713;440;117;323;-1;
2025-08-07 14:42:33.214;440;117;323;-1;
2025-08-07 14:42:33.713;443;122;321;-1;
2025-08-07 14:42:34.214;443;122;321;-1;
2025-08-07 14:42:34.713;442;118;324;-1;
2025-08-07 14:42:35.215;442;118;324;-1;
2025-08-07 14:42:35.713;442;113;329;-1;
2025-08-07 14:42:36.214;442;113;329;-1;
2025-08-07 14:42:36.713;441;111;330;-1;
2025-08-07 14:42:37.213;441;111;330;-1;
2025-08-07 14:42:37.714;440;118;322;-1;
2025-08-07 14:42:38.213;440;118;322;-1;
2025-08-07 14:42:38.714;465;142;323;-1;
2025-08-07 14:42:39.213;465;142;323;-1;
2025-08-07 14:42:39.713;494;172;322;-1;
2025-08-07 14:42:40.214;494;172;322;-1;
2025-08-07 14:42:40.713;494;178;316;-1;
2025-08-07 14:42:41.213;494;178;316;-1;
2025-08-07 14:42:41.713;495;142;353;-1;
2025-08-07 14:42:42.214;495;142;353;-1;
2025-08-07 14:42:42.713;494;165;329;-1;
2025-08-07 14:42:43.213;494;165;329;-1;
2025-08-07 14:42:43.713;495;156;339;-1;
2025-08-07 14:42:44.213;495;156;339;-1;
2025-08-07 14:42:44.714;494;149;345;-1;
2025-08-07 14:42:45.213;494;149;345;-1;
2025-08-07 14:42:45.713;494;157;337;-1;
2025-08-07 14:42:46.213;494;157;337;-1;
2025-08-07 14:42:46.713;495;156;339;-1;
2025-08-07 14:42:47.213;495;156;339;-1;
2025-08-07 14:42:47.713;495;155;340;-1;
2025-08-07 14:42:48.213;495;155;340;-1;
2025-08-07 14:42:48.714;495;156;339;-1;
2025-08-07 14:42:49.213;495;156;339;-1;
2025-08-07 14:42:49.713;493;151;342;-1;
2025-08-07 14:42:50.213;493;151;342;-1;
2025-08-07 14:42:50.713;496;154;342;-1;
2025-08-07 14:42:51.213;496;154;342;-1;
2025-08-07 14:42:51.713;494;155;339;-1;
2025-08-07 14:42:52.216;494;155;339;-1;
2025-08-07 14:42:52.713;494;140;354;-1;
2025-08-07 14:42:53.213;494;140;354;-1;
2025-08-07 14:42:53.713;494;155;339;-1;
2025-08-07 14:42:54.213;494;155;339;-1;
2025-08-07 14:42:54.713;496;155;341;-1;
