time;solar;injection;conso;power_limit;delay
2025-08-07 14:26:13.751;1844;1233;611;-1;
2025-08-07 14:26:14.251;1843;1230;613;-1;
2025-08-07 14:26:14.752;1843;1230;613;-1;
2025-08-07 14:26:15.251;1843;1260;583;-1;
2025-08-07 14:26:15.751;1843;1260;583;-1;
2025-08-07 14:26:16.251;1838;1299;539;-1;
2025-08-07 14:26:16.750;1838;1299;539;-1;
2025-08-07 14:26:17.251;1840;1202;638;-1;
2025-08-07 14:26:17.750;1840;1202;638;-1;
2025-08-07 14:26:18.250;1843;1228;615;-1;
2025-08-07 14:26:18.750;1843;1228;615;-1;
2025-08-07 14:26:19.250;1845;1245;600;-1;
2025-08-07 14:26:19.750;1845;1245;600;-1;
2025-08-07 14:26:20.251;1844;1200;644;-1;
2025-08-07 14:26:20.750;1844;1200;644;-1;
2025-08-07 14:26:21.250;1842;1291;551;-1;
2025-08-07 14:26:21.750;1842;1291;551;-1;
2025-08-07 14:26:22.250;1844;1178;666;-1;
2025-08-07 14:26:22.751;1844;1178;666;-1;
2025-08-07 14:26:23.250;1845;1227;618;-1;
2025-08-07 14:26:23.749;1845;1227;618;-1;
2025-08-07 14:26:24.249;1844;1220;624;-1;
2025-08-07 14:26:24.750;1844;1220;624;-1;
2025-08-07 14:26:25.250;1843;1224;619;-1;
2025-08-07 14:26:25.750;1843;1224;619;-1;
2025-08-07 14:26:26.250;1842;1254;588;-1;
2025-08-07 14:26:26.750;1842;1254;588;-1;
2025-08-07 14:26:27.250;1840;1242;598;-1;
2025-08-07 14:26:27.750;1840;1242;598;-1;
2025-08-07 14:26:28.250;1841;1158;683;-1;
2025-08-07 14:26:28.749;1841;1158;683;-1;
2025-08-07 14:26:29.250;1840;1259;581;-1;
2025-08-07 14:26:29.749;1840;1259;581;-1;
2025-08-07 14:26:30.250;1843;1230;613;-1;
2025-08-07 14:26:30.749;1843;1230;613;-1;
2025-08-07 14:26:31.250;1839;1231;608;-1;
2025-08-07 14:26:31.750;1839;1231;608;-1;
2025-08-07 14:26:32.249;1843;1305;538;-1;
2025-08-07 14:26:32.750;1843;1305;538;-1;
2025-08-07 14:26:33.250;1839;1172;667;-1;
2025-08-07 14:26:33.760;1839;1172;667;-1;
2025-08-07 14:26:34.252;1841;1162;679;-1;
2025-08-07 14:26:34.749;1841;1162;679;-1;
2025-08-07 14:26:34.895;9;write_maxpower_HTTP. Ecriture HTTP de maxpower = 220W pour 3 devices
2025-08-07 14:26:35.250;1841;1266;575;-1;
2025-08-07 14:26:35.749;1841;1266;575;-1;
2025-08-07 14:26:36.249;1841;1286;555;-1;
2025-08-07 14:26:36.749;1841;1286;555;-1;
2025-08-07 14:26:37.250;1838;1299;539;-1;
2025-08-07 14:26:37.750;1838;1299;539;-1;
2025-08-07 14:26:38.250;1842;1210;632;-1;
2025-08-07 14:26:38.749;1842;1210;632;-1;
2025-08-07 14:26:39.250;1843;1446;397;-1;
2025-08-07 14:26:39.749;1843;1446;397;-1;
2025-08-07 14:26:40.233;9;write_maxpower_HTTP. Fin d'exécution de la procédure
2025-08-07 14:26:40.291;1841;1455;386;-1;
2025-08-07 14:26:40.750;1841;1455;386;-1;
2025-08-07 14:26:41.255;1841;1458;383;-1;
2025-08-07 14:26:41.750;1841;1458;383;-1;
2025-08-07 14:26:42.249;1833;1432;401;-1;
2025-08-07 14:26:42.749;1833;1432;401;-1;
2025-08-07 14:26:43.251;1844;1444;400;-1;
2025-08-07 14:26:43.749;1844;1444;400;-1;
2025-08-07 14:26:44.250;1831;1384;447;-1;
2025-08-07 14:26:44.749;1831;1384;447;-1;
2025-08-07 14:26:45.250;1793;1223;570;-1;
2025-08-07 14:26:45.749;1793;1223;570;-1;
2025-08-07 14:26:46.249;1739;1134;605;-1;
2025-08-07 14:26:46.750;1739;1134;605;-1;
2025-08-07 14:26:47.250;1676;984;692;-1;
2025-08-07 14:26:47.749;1676;984;692;-1;
2025-08-07 14:26:48.250;1608;1047;561;-1;
2025-08-07 14:26:48.749;1608;1047;561;-1;
2025-08-07 14:26:49.250;1536;944;592;-1;
2025-08-07 14:26:49.749;1536;944;592;-1;
2025-08-07 14:26:50.250;1500;923;577;-1;
2025-08-07 14:26:50.749;1500;923;577;-1;
2025-08-07 14:26:51.249;1477;908;569;-1;
2025-08-07 14:26:51.749;1477;908;569;-1;
2025-08-07 14:26:52.250;1450;847;603;-1;
2025-08-07 14:26:52.749;1450;847;603;-1;
2025-08-07 14:26:53.250;1425;842;583;-1;
2025-08-07 14:26:53.749;1425;842;583;-1;
2025-08-07 14:26:54.249;1402;815;587;-1;
2025-08-07 14:26:54.749;1402;815;587;-1;
2025-08-07 14:26:55.249;1368;806;562;-1;
2025-08-07 14:26:55.748;1368;806;562;-1;
2025-08-07 14:26:56.249;1320;727;593;-1;
2025-08-07 14:26:56.748;1320;727;593;-1;
2025-08-07 14:26:57.249;1269;616;653;-1;
2025-08-07 14:26:57.748;1269;616;653;-1;
2025-08-07 14:26:58.248;1256;630;626;-1;
2025-08-07 14:26:58.748;1256;630;626;-1;
2025-08-07 14:26:59.249;1255;667;588;-1;
2025-08-07 14:26:59.748;1255;667;588;-1;
2025-08-07 14:27:00.248;1256;641;615;-1;
2025-08-07 14:27:00.748;1256;641;615;-1;
2025-08-07 14:27:01.248;1259;680;579;-1;
2025-08-07 14:27:01.749;1259;680;579;-1;
2025-08-07 14:27:02.248;1257;687;570;-1;
2025-08-07 14:27:02.749;1257;687;570;-1;
2025-08-07 14:27:03.371;1256;621;635;-1;
2025-08-07 14:27:03.748;1256;621;635;-1;
2025-08-07 14:27:04.249;1255;696;559;-1;
2025-08-07 14:27:04.749;1255;696;559;-1;
2025-08-07 14:27:05.248;1256;673;583;-1;
2025-08-07 14:27:05.748;1256;673;583;-1;
2025-08-07 14:27:06.248;1255;688;567;-1;
2025-08-07 14:27:06.749;1255;688;567;-1;
2025-08-07 14:27:07.248;1255;727;528;-1;
2025-08-07 14:27:07.748;1255;727;528;-1;
2025-08-07 14:27:08.249;1256;622;634;-1;
2025-08-07 14:27:08.748;1256;622;634;-1;
2025-08-07 14:27:09.248;1254;655;599;-1;
2025-08-07 14:27:09.748;1254;655;599;-1;
2025-08-07 14:27:10.248;1259;657;602;-1;
2025-08-07 14:27:10.748;1259;657;602;-1;
2025-08-07 14:27:11.248;1255;633;622;-1;
2025-08-07 14:27:11.748;1255;633;622;-1;
2025-08-07 14:27:12.249;1255;710;545;-1;
2025-08-07 14:27:12.748;1255;710;545;-1;
2025-08-07 14:27:13.250;1256;642;614;-1;
2025-08-07 14:27:13.748;1256;642;614;-1;
2025-08-07 14:27:14.248;1255;875;380;-1;
2025-08-07 14:27:14.748;1255;875;380;-1;
2025-08-07 14:27:15.248;1256;852;404;-1;
2025-08-07 14:27:15.749;1256;852;404;-1;
2025-08-07 14:27:16.248;1253;853;400;-1;
2025-08-07 14:27:16.748;1253;853;400;-1;
2025-08-07 14:27:17.299;1255;854;401;-1;
2025-08-07 14:27:17.748;1255;854;401;-1;
2025-08-07 14:27:18.364;1256;855;401;-1;
2025-08-07 14:27:18.827;1256;855;401;-1;
2025-08-07 14:27:19.248;1255;809;446;-1;
2025-08-07 14:27:19.913;1255;809;446;-1;
2025-08-07 14:27:20.361;1253;684;569;-1;
2025-08-07 14:27:20.785;1253;684;569;-1;
2025-08-07 14:27:21.418;1252;683;569;-1;
2025-08-07 14:27:21.750;1252;683;569;-1;
2025-08-07 14:27:22.248;1253;634;619;-1;
2025-08-07 14:27:22.747;1253;634;619;-1;
2025-08-07 14:27:23.248;1253;657;596;-1;
2025-08-07 14:27:23.747;1253;657;596;-1;
2025-08-07 14:27:24.248;1251;657;594;-1;
2025-08-07 14:27:24.748;1251;657;594;-1;
2025-08-07 14:27:25.248;1254;706;548;-1;
2025-08-07 14:27:25.747;1254;706;548;-1;
2025-08-07 14:27:26.248;1251;725;526;-1;
2025-08-07 14:27:26.747;1251;725;526;-1;
2025-08-07 14:27:27.247;1254;640;614;-1;
2025-08-07 14:27:27.748;1254;640;614;-1;
2025-08-07 14:27:28.248;1255;637;618;-1;
2025-08-07 14:27:28.748;1255;637;618;-1;
2025-08-07 14:27:29.248;1254;677;577;-1;
2025-08-07 14:27:29.747;1254;677;577;-1;
2025-08-07 14:27:30.248;1254;712;542;-1;
2025-08-07 14:27:30.747;1254;712;542;-1;
2025-08-07 14:27:31.248;1255;759;496;-1;
2025-08-07 14:27:31.747;1255;759;496;-1;
2025-08-07 14:27:32.248;1255;692;563;-1;
2025-08-07 14:27:32.747;1255;692;563;-1;
2025-08-07 14:27:33.247;1253;641;612;-1;
2025-08-07 14:27:33.747;1253;641;612;-1;
2025-08-07 14:27:34.248;1255;712;543;-1;
2025-08-07 14:27:34.747;1255;712;543;-1;
2025-08-07 14:27:35.247;1253;713;540;-1;
2025-08-07 14:27:35.747;1253;713;540;-1;
2025-08-07 14:27:36.247;1253;731;522;-1;
2025-08-07 14:27:36.747;1253;731;522;-1;
2025-08-07 14:27:37.247;1253;713;540;-1;
2025-08-07 14:27:37.747;1253;713;540;-1;
2025-08-07 14:27:38.248;1254;629;625;-1;
2025-08-07 14:27:38.747;1254;629;625;-1;
2025-08-07 14:27:39.247;1253;645;608;-1;
2025-08-07 14:27:39.747;1253;645;608;-1;
2025-08-07 14:27:40.247;1254;710;544;-1;
2025-08-07 14:27:40.747;1254;710;544;-1;
2025-08-07 14:27:41.247;1254;676;578;-1;
2025-08-07 14:27:41.747;1254;676;578;-1;
2025-08-07 14:27:42.248;1254;752;502;-1;
2025-08-07 14:27:42.747;1254;752;502;-1;
2025-08-07 14:27:43.248;1254;651;603;-1;
2025-08-07 14:27:43.747;1254;651;603;-1;
2025-08-07 14:27:44.247;1255;657;598;-1;
2025-08-07 14:27:44.747;1255;657;598;-1;
2025-08-07 14:27:45.246;1252;675;577;-1;
2025-08-07 14:27:45.747;1252;675;577;-1;
2025-08-07 14:27:46.251;1252;710;542;-1;
2025-08-07 14:27:46.746;1252;710;542;-1;
2025-08-07 14:27:47.247;1255;697;558;-1;
2025-08-07 14:27:47.509;9;write_maxpower_HTTP. Ecriture HTTP de maxpower = 132W pour 3 devices
2025-08-07 14:27:47.747;1255;697;558;-1;
2025-08-07 14:27:48.248;1254;673;581;-1;
2025-08-07 14:27:48.746;1254;673;581;-1;
2025-08-07 14:27:49.248;1253;906;347;-1;
2025-08-07 14:27:49.746;1253;906;347;-1;
2025-08-07 14:27:50.246;1252;905;347;-1;
2025-08-07 14:27:50.747;1252;905;347;-1;
2025-08-07 14:27:51.247;1253;904;349;-1;
2025-08-07 14:27:51.747;1253;904;349;-1;
2025-08-07 14:27:52.247;1253;902;351;-1;
2025-08-07 14:27:52.664;9;write_maxpower_HTTP. Fin d'exécution de la procédure
2025-08-07 14:27:52.747;1253;902;351;-1;
2025-08-07 14:27:53.247;1255;142;1113;-1;
2025-08-07 14:27:53.746;1255;142;1113;-1;
2025-08-07 14:27:54.247;1256;741;515;-1;
2025-08-07 14:27:54.746;1256;741;515;-1;
2025-08-07 14:27:55.248;1255;601;654;-1;
2025-08-07 14:27:55.746;1255;601;654;-1;
2025-08-07 14:27:56.246;1212;554;658;-1;
2025-08-07 14:27:56.746;1212;554;658;-1;
2025-08-07 14:27:57.247;1155;470;685;-1;
2025-08-07 14:27:57.746;1155;470;685;-1;
2025-08-07 14:27:58.247;1099;465;634;-1;
2025-08-07 14:27:58.746;1099;465;634;-1;
2025-08-07 14:27:59.248;976;287;689;-1;
2025-08-07 14:27:59.747;976;287;689;-1;
2025-08-07 14:28:00.247;678;0;678;-1;
2025-08-07 14:28:00.746;678;0;678;-1;
2025-08-07 14:28:01.261;666;-21;687;-1;
2025-08-07 14:28:01.746;666;-21;687;-1;
2025-08-07 14:28:02.246;667;-102;769;-1;
2025-08-07 14:28:02.746;667;-102;769;-1;
2025-08-07 14:28:03.360;667;-20;687;-1;
2025-08-07 14:28:03.747;667;-20;687;-1;
2025-08-07 14:28:04.247;666;-27;693;-1;
2025-08-07 14:28:04.746;666;-27;693;-1;
2025-08-07 14:28:05.247;666;-26;692;-1;
2025-08-07 14:28:05.746;666;-26;692;-1;
2025-08-07 14:28:06.247;666;-43;709;-1;
2025-08-07 14:28:06.745;666;-43;709;-1;
2025-08-07 14:28:07.246;643;-106;749;-1;
2025-08-07 14:28:07.745;643;-106;749;-1;
2025-08-07 14:28:08.246;599;-86;685;-1;
2025-08-07 14:28:08.745;599;-86;685;-1;
2025-08-07 14:28:09.246;556;-94;650;-1;
2025-08-07 14:28:09.745;556;-94;650;-1;
2025-08-07 14:28:10.247;266;-371;637;-1;
2025-08-07 14:28:10.745;266;-371;637;-1;
2025-08-07 14:28:11.246;266;-368;634;-1;
2025-08-07 14:28:11.747;266;-368;634;-1;
2025-08-07 14:28:12.246;263;-373;636;-1;
2025-08-07 14:28:12.746;263;-373;636;-1;
2025-08-07 14:28:13.247;264;-393;657;-1;
2025-08-07 14:28:13.745;264;-393;657;-1;
2025-08-07 14:28:14.246;264;-392;656;-1;
2025-08-07 14:28:14.746;264;-392;656;-1;
2025-08-07 14:28:15.246;264;-357;621;-1;
2025-08-07 14:28:15.749;264;-357;621;-1;
2025-08-07 14:28:16.246;265;-361;626;-1;
2025-08-07 14:28:16.746;265;-361;626;-1;
2025-08-07 14:28:17.246;267;-344;611;-1;
2025-08-07 14:28:17.746;267;-344;611;-1;
2025-08-07 14:28:18.246;263;-373;636;-1;
2025-08-07 14:28:18.745;263;-373;636;-1;
2025-08-07 14:28:19.245;267;-372;639;-1;
2025-08-07 14:28:19.746;267;-372;639;-1;
2025-08-07 14:28:20.246;263;-383;646;-1;
2025-08-07 14:28:20.751;263;-383;646;-1;
2025-08-07 14:28:21.247;264;-360;624;-1;
2025-08-07 14:28:21.745;264;-360;624;-1;
2025-08-07 14:28:22.246;264;-343;607;-1;
2025-08-07 14:28:22.745;264;-343;607;-1;
2025-08-07 14:28:23.246;266;-409;675;-1;
2025-08-07 14:28:23.745;266;-409;675;-1;
2025-08-07 14:28:24.247;262;-167;429;-1;
2025-08-07 14:28:24.745;262;-167;429;-1;
2025-08-07 14:28:25.245;262;-167;429;-1;
2025-08-07 14:28:25.745;262;-167;429;-1;
2025-08-07 14:28:26.246;261;-177;438;-1;
2025-08-07 14:28:26.745;261;-177;438;-1;
2025-08-07 14:28:27.247;264;-162;426;-1;
2025-08-07 14:28:27.745;264;-162;426;-1;
2025-08-07 14:28:28.246;263;-182;445;-1;
2025-08-07 14:28:28.745;263;-182;445;-1;
2025-08-07 14:28:29.246;266;-268;534;-1;
2025-08-07 14:28:29.745;266;-268;534;-1;
2025-08-07 14:28:30.246;262;-425;687;-1;
2025-08-07 14:28:30.745;262;-425;687;-1;
2025-08-07 14:28:31.246;266;-385;651;-1;
2025-08-07 14:28:31.745;266;-385;651;-1;
2025-08-07 14:28:32.246;262;-460;722;-1;
2025-08-07 14:28:32.745;262;-460;722;-1;
2025-08-07 14:28:33.246;266;-391;657;-1;
2025-08-07 14:28:33.745;266;-391;657;-1;
2025-08-07 14:28:34.246;263;-387;650;-1;
2025-08-07 14:28:34.745;263;-387;650;-1;
2025-08-07 14:28:35.245;267;-364;631;-1;
2025-08-07 14:28:35.745;267;-364;631;-1;
2025-08-07 14:28:36.246;263;-314;577;-1;
2025-08-07 14:28:36.745;263;-314;577;-1;
2025-08-07 14:28:37.246;265;-409;674;-1;
2025-08-07 14:28:37.745;265;-409;674;-1;
2025-08-07 14:28:38.245;265;-429;694;-1;
2025-08-07 14:28:38.745;265;-429;694;-1;
2025-08-07 14:28:39.246;265;-355;620;-1;
2025-08-07 14:28:39.745;265;-355;620;-1;
2025-08-07 14:28:40.246;263;-401;664;-1;
2025-08-07 14:28:40.744;263;-401;664;-1;
2025-08-07 14:28:41.246;265;-352;617;-1;
2025-08-07 14:28:41.745;265;-352;617;-1;
2025-08-07 14:28:42.245;265;-398;663;-1;
2025-08-07 14:28:42.744;265;-398;663;-1;
2025-08-07 14:28:43.245;264;-418;682;-1;
2025-08-07 14:28:43.745;264;-418;682;-1;
2025-08-07 14:28:44.245;263;-386;649;-1;
2025-08-07 14:28:44.744;263;-386;649;-1;
2025-08-07 14:28:45.245;263;-390;653;-1;
2025-08-07 14:28:45.745;263;-390;653;-1;
2025-08-07 14:28:46.246;264;-347;611;-1;
2025-08-07 14:28:46.744;264;-347;611;-1;
2025-08-07 14:28:47.245;264;-365;629;-1;
2025-08-07 14:28:47.745;264;-365;629;-1;
2025-08-07 14:28:48.245;268;-439;707;-1;
2025-08-07 14:28:48.745;268;-439;707;-1;
2025-08-07 14:28:49.244;265;-409;674;-1;
2025-08-07 14:28:49.745;265;-409;674;-1;
2025-08-07 14:28:50.245;265;-400;665;-1;
2025-08-07 14:28:50.744;265;-400;665;-1;
2025-08-07 14:28:51.245;264;-395;659;-1;
2025-08-07 14:28:51.744;264;-395;659;-1;
2025-08-07 14:28:52.245;265;-320;585;-1;
2025-08-07 14:28:52.744;265;-320;585;-1;
2025-08-07 14:28:53.244;266;-430;696;-1;
2025-08-07 14:28:53.744;266;-430;696;-1;
2025-08-07 14:28:54.245;264;-411;675;-1;
2025-08-07 14:28:54.744;264;-411;675;-1;
2025-08-07 14:28:55.250;265;-393;658;-1;
2025-08-07 14:28:55.744;265;-393;658;-1;
2025-08-07 14:28:56.244;265;-416;681;-1;
2025-08-07 14:28:56.744;265;-416;681;-1;
2025-08-07 14:28:57.245;265;-323;588;-1;
2025-08-07 14:28:57.744;265;-323;588;-1;
2025-08-07 14:28:58.244;266;-393;659;-1;
2025-08-07 14:28:58.744;266;-393;659;-1;
2025-08-07 14:28:59.244;262;-185;447;-1;
2025-08-07 14:28:59.744;262;-185;447;-1;
2025-08-07 14:29:00.243;263;-172;435;-1;
2025-08-07 14:29:00.743;263;-172;435;-1;
2025-08-07 14:29:01.245;265;-218;483;-1;
2025-08-07 14:29:01.744;265;-218;483;-1;
2025-08-07 14:29:02.244;266;-195;461;-1;
2025-08-07 14:29:02.744;266;-195;461;-1;
2025-08-07 14:29:03.387;266;-181;447;-1;
2025-08-07 14:29:03.744;266;-181;447;-1;
2025-08-07 14:29:04.243;264;-250;514;-1;
2025-08-07 14:29:04.746;264;-250;514;-1;
2025-08-07 14:29:05.245;266;-441;707;-1;
2025-08-07 14:29:05.743;266;-441;707;-1;
2025-08-07 14:29:06.244;262;-433;695;-1;
2025-08-07 14:29:06.743;262;-433;695;-1;
2025-08-07 14:29:06.824;9;write_maxpower_HTTP. Ecriture HTTP de maxpower = 44W pour 3 devices
2025-08-07 14:29:07.244;265;-461;726;-1;
2025-08-07 14:29:07.743;265;-461;726;-1;
2025-08-07 14:29:08.245;264;-336;600;-1;
2025-08-07 14:29:08.744;264;-336;600;-1;
2025-08-07 14:29:09.245;265;-377;642;-1;
2025-08-07 14:29:09.744;265;-377;642;-1;
2025-08-07 14:29:10.244;263;-387;650;-1;
2025-08-07 14:29:10.744;263;-387;650;-1;
2025-08-07 14:29:11.245;265;-345;610;-1;
2025-08-07 14:29:11.744;265;-345;610;-1;
2025-08-07 14:29:12.056;9;write_maxpower_HTTP. Fin d'exécution de la procédure
2025-08-07 14:29:12.245;265;-369;634;-1;
2025-08-07 14:29:12.744;265;-369;634;-1;
2025-08-07 14:29:13.244;262;-402;664;-1;
2025-08-07 14:29:13.743;262;-402;664;-1;
2025-08-07 14:29:14.245;264;-360;624;-1;
2025-08-07 14:29:14.744;264;-360;624;-1;
2025-08-07 14:29:15.243;265;-373;638;-1;
2025-08-07 14:29:15.744;265;-373;638;-1;
2025-08-07 14:29:16.244;264;-355;619;-1;
2025-08-07 14:29:16.743;264;-355;619;-1;
2025-08-07 14:29:17.244;266;-400;666;-1;
2025-08-07 14:29:17.743;266;-400;666;-1;
2025-08-07 14:29:18.244;250;-421;671;-1;
2025-08-07 14:29:18.743;250;-421;671;-1;
2025-08-07 14:29:19.244;228;-402;630;-1;
2025-08-07 14:29:19.744;228;-402;630;-1;
2025-08-07 14:29:20.245;210;-451;661;-1;
2025-08-07 14:29:20.743;210;-451;661;-1;
2025-08-07 14:29:21.245;192;-416;608;-1;
2025-08-07 14:29:21.743;192;-416;608;-1;
2025-08-07 14:29:22.244;177;-463;640;-1;
2025-08-07 14:29:22.744;177;-463;640;-1;
2025-08-07 14:29:23.244;164;-545;709;-1;
2025-08-07 14:29:23.743;164;-545;709;-1;
2025-08-07 14:29:24.244;152;-456;608;-1;
2025-08-07 14:29:24.743;152;-456;608;-1;
2025-08-07 14:29:25.243;140;-518;658;-1;
2025-08-07 14:29:25.743;140;-518;658;-1;
2025-08-07 14:29:26.244;129;-525;654;-1;
2025-08-07 14:29:26.743;129;-525;654;-1;
2025-08-07 14:29:27.244;119;-481;600;-1;
2025-08-07 14:29:27.743;119;-481;600;-1;
2025-08-07 14:29:28.244;110;-583;693;-1;
2025-08-07 14:29:28.744;110;-583;693;-1;
2025-08-07 14:29:29.249;102;-564;666;-1;
2025-08-07 14:29:29.744;102;-564;666;-1;
2025-08-07 14:29:30.439;94;-520;614;-1;
2025-08-07 14:29:30.768;94;-520;614;-1;
2025-08-07 14:29:31.243;89;-547;636;-1;
2025-08-07 14:29:31.999;89;-547;636;-1;
2025-08-07 14:29:32.243;91;-535;626;-1;
2025-08-07 14:29:32.881;91;-535;626;-1;
2025-08-07 14:29:33.243;90;-572;662;-1;
2025-08-07 14:29:33.798;90;-572;662;-1;
2025-08-07 14:29:34.244;91;-362;453;-1;
2025-08-07 14:29:34.743;91;-362;453;-1;
2025-08-07 14:29:35.243;92;-362;454;-1;
2025-08-07 14:29:35.742;92;-362;454;-1;
2025-08-07 14:29:36.242;92;-362;454;-1;
2025-08-07 14:29:36.743;92;-362;454;-1;
2025-08-07 14:29:37.243;93;-364;457;-1;
2025-08-07 14:29:37.742;93;-364;457;-1;
2025-08-07 14:29:38.242;92;-353;445;-1;
2025-08-07 14:29:38.742;92;-353;445;-1;
2025-08-07 14:29:39.243;92;-395;487;-1;
2025-08-07 14:29:39.742;92;-395;487;-1;
2025-08-07 14:29:40.243;90;-573;663;-1;
2025-08-07 14:29:40.742;90;-573;663;-1;
2025-08-07 14:29:41.243;91;-507;598;-1;
2025-08-07 14:29:41.742;91;-507;598;-1;
2025-08-07 14:29:42.243;91;-613;704;-1;
2025-08-07 14:29:42.744;91;-613;704;-1;
2025-08-07 14:29:43.242;92;-611;703;-1;
2025-08-07 14:29:43.750;92;-611;703;-1;
2025-08-07 14:29:44.243;93;-522;615;-1;
2025-08-07 14:29:44.742;93;-522;615;-1;
2025-08-07 14:29:45.242;94;-555;649;-1;
2025-08-07 14:29:45.743;94;-555;649;-1;
2025-08-07 14:29:46.242;89;-503;592;-1;
2025-08-07 14:29:46.742;89;-503;592;-1;
2025-08-07 14:29:47.243;94;-605;699;-1;
2025-08-07 14:29:47.742;94;-605;699;-1;
2025-08-07 14:29:48.242;93;-631;724;-1;
2025-08-07 14:29:48.742;93;-631;724;-1;
2025-08-07 14:29:49.243;92;-528;620;-1;
2025-08-07 14:29:49.742;92;-528;620;-1;
2025-08-07 14:29:50.243;91;-545;636;-1;
2025-08-07 14:29:50.742;91;-545;636;-1;
2025-08-07 14:29:51.243;93;-502;595;-1;
2025-08-07 14:29:51.742;93;-502;595;-1;
2025-08-07 14:29:52.243;93;-551;644;-1;
2025-08-07 14:29:52.742;93;-551;644;-1;
2025-08-07 14:29:53.243;90;-618;708;-1;
2025-08-07 14:29:53.742;90;-618;708;-1;
2025-08-07 14:29:54.243;93;-552;645;-1;
2025-08-07 14:29:54.742;93;-552;645;-1;
2025-08-07 14:29:55.242;93;-556;649;-1;
2025-08-07 14:29:55.742;93;-556;649;-1;
2025-08-07 14:29:56.242;91;-517;608;-1;
2025-08-07 14:29:56.742;91;-517;608;-1;
2025-08-07 14:29:57.242;94;-493;587;-1;
2025-08-07 14:29:57.742;94;-493;587;-1;
2025-08-07 14:29:58.243;90;-591;681;-1;
2025-08-07 14:29:58.742;90;-591;681;-1;
2025-08-07 14:29:59.242;90;-553;643;-1;
2025-08-07 14:29:59.741;90;-553;643;-1;
2025-08-07 14:30:00.241;91;-562;653;-1;
2025-08-07 14:30:00.754;91;-562;653;-1;
2025-08-07 14:30:01.242;88;-584;672;-1;
2025-08-07 14:30:01.741;88;-584;672;-1;
2025-08-07 14:30:02.242;94;-514;608;-1;
2025-08-07 14:30:02.742;94;-514;608;-1;
2025-08-07 14:30:03.402;91;-591;682;-1;
2025-08-07 14:30:03.744;91;-591;682;-1;
2025-08-07 14:30:04.243;92;-630;722;-1;
2025-08-07 14:30:04.742;92;-630;722;-1;
2025-08-07 14:30:05.245;92;-561;653;-1;
2025-08-07 14:30:05.741;92;-561;653;-1;
2025-08-07 14:30:06.242;90;-565;655;-1;
2025-08-07 14:30:06.741;90;-565;655;-1;
2025-08-07 14:30:07.244;91;-511;602;-1;
2025-08-07 14:30:07.742;91;-511;602;-1;
2025-08-07 14:30:08.242;92;-584;676;-1;
2025-08-07 14:30:08.741;92;-584;676;-1;
2025-08-07 14:30:09.242;91;-363;454;-1;
2025-08-07 14:30:09.741;91;-363;454;-1;
2025-08-07 14:30:10.235;9;write_maxpower_HTTP. Ecriture HTTP de maxpower = 132W pour 3 devices
2025-08-07 14:30:10.285;92;-359;451;-1;
2025-08-07 14:30:10.741;92;-359;451;-1;
2025-08-07 14:30:11.242;92;-343;435;-1;
2025-08-07 14:30:11.741;92;-343;435;-1;
2025-08-07 14:30:12.241;93;-341;434;-1;
2025-08-07 14:30:12.741;93;-341;434;-1;
2025-08-07 14:30:13.241;93;-338;431;-1;
2025-08-07 14:30:13.741;93;-338;431;-1;
2025-08-07 14:30:14.242;91;-410;501;-1;
2025-08-07 14:30:14.741;91;-410;501;-1;
2025-08-07 14:30:15.242;91;-598;689;-1;
2025-08-07 14:30:15.405;9;write_maxpower_HTTP. Fin d'exécution de la procédure
2025-08-07 14:30:15.741;91;-598;689;-1;
2025-08-07 14:30:16.242;91;-539;630;-1;
2025-08-07 14:30:16.741;91;-539;630;-1;
2025-08-07 14:30:17.242;91;-634;725;-1;
2025-08-07 14:30:17.741;91;-634;725;-1;
2025-08-07 14:30:18.242;93;-497;590;-1;
2025-08-07 14:30:18.741;93;-497;590;-1;
2025-08-07 14:30:19.242;93;-572;665;-1;
2025-08-07 14:30:19.741;93;-572;665;-1;
2025-08-07 14:30:20.243;93;-491;584;-1;
2025-08-07 14:30:20.741;93;-491;584;-1;
2025-08-07 14:30:21.242;93;-529;622;-1;
2025-08-07 14:30:21.741;93;-529;622;-1;
2025-08-07 14:30:22.242;97;-570;667;-1;
2025-08-07 14:30:22.741;97;-570;667;-1;
2025-08-07 14:30:23.241;130;-546;676;-1;
2025-08-07 14:30:23.746;130;-546;676;-1;
2025-08-07 14:30:24.249;169;-489;658;-1;
2025-08-07 14:30:24.743;169;-489;658;-1;
2025-08-07 14:30:25.241;208;-467;675;-1;
2025-08-07 14:30:25.741;208;-467;675;-1;
2025-08-07 14:30:26.250;234;-355;589;-1;
2025-08-07 14:30:26.745;234;-355;589;-1;
2025-08-07 14:30:27.244;269;-363;632;-1;
2025-08-07 14:30:27.740;269;-363;632;-1;
2025-08-07 14:30:28.242;264;-421;685;-1;
2025-08-07 14:30:28.740;264;-421;685;-1;
2025-08-07 14:30:29.242;265;-352;617;-1;
2025-08-07 14:30:29.741;265;-352;617;-1;
2025-08-07 14:30:30.241;265;-393;658;-1;
2025-08-07 14:30:30.745;265;-393;658;-1;
2025-08-07 14:30:31.241;264;-303;567;-1;
2025-08-07 14:30:31.741;264;-303;567;-1;
2025-08-07 14:30:32.240;269;-355;624;-1;
2025-08-07 14:30:32.740;269;-355;624;-1;
2025-08-07 14:30:33.241;262;-439;701;-1;
2025-08-07 14:30:33.740;262;-439;701;-1;
2025-08-07 14:30:34.241;263;-367;630;-1;
2025-08-07 14:30:34.740;263;-367;630;-1;
2025-08-07 14:30:35.241;263;-386;649;-1;
2025-08-07 14:30:35.740;263;-386;649;-1;
2025-08-07 14:30:36.241;264;-297;561;-1;
2025-08-07 14:30:36.740;264;-297;561;-1;
2025-08-07 14:30:37.241;262;-366;628;-1;
2025-08-07 14:30:37.740;262;-366;628;-1;
2025-08-07 14:30:38.241;265;-485;750;-1;
2025-08-07 14:30:38.740;265;-485;750;-1;
2025-08-07 14:30:39.243;263;-394;657;-1;
2025-08-07 14:30:39.740;263;-394;657;-1;
2025-08-07 14:30:40.240;263;-337;600;-1;
2025-08-07 14:30:40.740;263;-337;600;-1;
2025-08-07 14:30:41.240;266;-366;632;-1;
2025-08-07 14:30:41.740;266;-366;632;-1;
2025-08-07 14:30:42.241;266;-310;576;-1;
2025-08-07 14:30:42.740;266;-310;576;-1;
2025-08-07 14:30:43.240;265;-412;677;-1;
2025-08-07 14:30:43.740;265;-412;677;-1;
2025-08-07 14:30:44.240;264;-183;447;-1;
2025-08-07 14:30:44.740;264;-183;447;-1;
2025-08-07 14:30:45.240;263;-167;430;-1;
2025-08-07 14:30:45.740;263;-167;430;-1;
2025-08-07 14:30:46.240;264;-165;429;-1;
2025-08-07 14:30:46.740;264;-165;429;-1;
2025-08-07 14:30:47.240;265;-165;430;-1;
2025-08-07 14:30:47.740;265;-165;430;-1;
2025-08-07 14:30:48.240;263;-166;429;-1;
2025-08-07 14:30:48.740;263;-166;429;-1;
2025-08-07 14:30:49.241;266;-232;498;-1;
2025-08-07 14:30:49.740;266;-232;498;-1;
2025-08-07 14:30:50.242;263;-375;638;-1;
2025-08-07 14:30:50.740;263;-375;638;-1;
2025-08-07 14:30:51.240;265;-369;634;-1;
2025-08-07 14:30:51.740;265;-369;634;-1;
2025-08-07 14:30:52.242;265;-446;711;-1;
2025-08-07 14:30:52.740;265;-446;711;-1;
2025-08-07 14:30:53.242;265;-355;620;-1;
2025-08-07 14:30:53.739;265;-355;620;-1;
2025-08-07 14:30:54.243;265;-375;640;-1;
2025-08-07 14:30:54.739;265;-375;640;-1;
2025-08-07 14:30:55.240;266;-374;640;-1;
2025-08-07 14:30:55.740;266;-374;640;-1;
2025-08-07 14:30:56.244;265;-324;589;-1;
2025-08-07 14:30:56.739;265;-324;589;-1;
2025-08-07 14:30:57.244;265;-406;671;-1;
2025-08-07 14:30:57.740;265;-406;671;-1;
2025-08-07 14:30:58.244;263;-387;650;-1;
2025-08-07 14:30:58.740;263;-387;650;-1;
2025-08-07 14:30:59.245;263;-366;629;-1;
2025-08-07 14:30:59.739;263;-366;629;-1;
2025-08-07 14:31:00.245;265;-393;658;-1;
2025-08-07 14:31:00.739;265;-393;658;-1;
2025-08-07 14:31:01.245;266;-309;575;-1;
2025-08-07 14:31:01.740;266;-309;575;-1;
2025-08-07 14:31:02.246;265;-402;667;-1;
2025-08-07 14:31:02.739;265;-402;667;-1;
2025-08-07 14:31:03.432;265;-450;715;-1;
2025-08-07 14:31:03.739;265;-450;715;-1;
2025-08-07 14:31:04.246;265;-379;644;-1;
2025-08-07 14:31:04.739;265;-379;644;-1;
2025-08-07 14:31:05.239;265;-385;650;-1;
2025-08-07 14:31:05.739;265;-385;650;-1;
2025-08-07 14:31:06.239;264;-370;634;-1;
2025-08-07 14:31:06.739;264;-370;634;-1;
2025-08-07 14:31:07.239;266;-364;630;-1;
2025-08-07 14:31:07.739;266;-364;630;-1;
2025-08-07 14:31:08.248;263;-423;686;-1;
2025-08-07 14:31:08.739;263;-423;686;-1;
2025-08-07 14:31:09.248;263;-173;436;-1;
2025-08-07 14:31:09.739;263;-173;436;-1;
2025-08-07 14:31:10.239;264;-181;445;-1;
2025-08-07 14:31:10.739;264;-181;445;-1;
2025-08-07 14:31:11.240;265;-175;440;-1;
2025-08-07 14:31:11.739;265;-175;440;-1;
2025-08-07 14:31:12.444;262;-177;439;-1;
2025-08-07 14:31:12.774;262;-177;439;-1;
2025-08-07 14:31:13.649;269;-189;458;-1;
2025-08-07 14:31:13.947;269;-189;458;-1;
2025-08-07 14:31:14.278;264;-169;433;-1;
2025-08-07 14:31:14.930;264;-169;433;-1;
2025-08-07 14:31:15.239;267;-161;428;-1;
2025-08-07 14:31:15.794;267;-161;428;-1;
2025-08-07 14:31:16.315;266;-169;435;-1;
2025-08-07 14:31:16.739;266;-169;435;-1;
2025-08-07 14:31:17.238;266;-177;443;-1;
2025-08-07 14:31:17.738;266;-177;443;-1;
2025-08-07 14:31:18.251;270;-178;448;-1;
2025-08-07 14:31:18.738;270;-178;448;-1;
2025-08-07 14:31:19.239;265;-185;450;-1;
2025-08-07 14:31:19.735;9;write_maxpower_HTTP. Ecriture HTTP de maxpower = 220W pour 3 devices
2025-08-07 14:31:19.783;265;-185;450;-1;
2025-08-07 14:31:20.252;265;-222;487;-1;
2025-08-07 14:31:20.739;265;-222;487;-1;
2025-08-07 14:31:21.254;267;-335;602;-1;
2025-08-07 14:31:21.739;267;-335;602;-1;
2025-08-07 14:31:22.253;266;-455;721;-1;
2025-08-07 14:31:22.739;266;-455;721;-1;
2025-08-07 14:31:23.254;264;-374;638;-1;
2025-08-07 14:31:23.739;264;-374;638;-1;
2025-08-07 14:31:24.238;265;-390;655;-1;
2025-08-07 14:31:24.738;265;-390;655;-1;
2025-08-07 14:31:25.013;9;write_maxpower_HTTP. Fin d'exécution de la procédure
2025-08-07 14:31:25.254;268;-168;436;-1;
2025-08-07 14:31:25.739;268;-168;436;-1;
2025-08-07 14:31:26.238;264;-172;436;-1;
2025-08-07 14:31:26.739;264;-172;436;-1;
2025-08-07 14:31:27.238;263;-165;428;-1;
2025-08-07 14:31:27.738;263;-165;428;-1;
2025-08-07 14:31:28.239;262;-173;435;-1;
2025-08-07 14:31:28.738;262;-173;435;-1;
2025-08-07 14:31:29.238;264;-169;433;-1;
2025-08-07 14:31:29.738;264;-169;433;-1;
2025-08-07 14:31:30.272;297;-131;428;-1;
2025-08-07 14:31:30.739;297;-131;428;-1;
2025-08-07 14:31:31.272;334;-94;428;-1;
2025-08-07 14:31:31.738;334;-94;428;-1;
2025-08-07 14:31:32.239;364;-63;427;-1;
2025-08-07 14:31:32.738;364;-63;427;-1;
2025-08-07 14:31:33.239;399;-30;429;-1;
2025-08-07 14:31:33.738;399;-30;429;-1;
2025-08-07 14:31:34.239;444;11;433;-1;
2025-08-07 14:31:34.739;444;11;433;-1;
2025-08-07 14:31:35.238;441;-30;471;-1;
2025-08-07 14:31:35.743;441;-30;471;-1;
2025-08-07 14:31:36.238;441;-308;749;-1;
2025-08-07 14:31:36.738;441;-308;749;-1;
2025-08-07 14:31:37.239;440;-204;644;-1;
2025-08-07 14:31:37.738;440;-204;644;-1;
2025-08-07 14:31:38.238;441;-219;660;-1;
2025-08-07 14:31:38.738;441;-219;660;-1;
2025-08-07 14:31:39.238;437;-250;687;-1;
2025-08-07 14:31:39.738;437;-250;687;-1;
2025-08-07 14:31:40.243;439;10;429;-1;
2025-08-07 14:31:40.738;439;10;429;-1;
2025-08-07 14:31:41.238;439;5;434;-1;
2025-08-07 14:31:41.738;439;5;434;-1;
2025-08-07 14:31:42.238;439;1;438;-1;
2025-08-07 14:31:42.738;439;1;438;-1;
2025-08-07 14:31:43.240;439;6;433;-1;
2025-08-07 14:31:43.738;439;6;433;-1;
2025-08-07 14:31:44.254;440;-17;457;-1;
2025-08-07 14:31:44.738;440;-17;457;-1;
2025-08-07 14:31:45.238;438;31;407;-1;
2025-08-07 14:31:45.738;438;31;407;-1;
2025-08-07 14:31:46.238;441;40;401;-1;
2025-08-07 14:31:46.737;441;40;401;-1;
2025-08-07 14:31:47.238;440;37;403;-1;
2025-08-07 14:31:47.738;440;37;403;-1;
2025-08-07 14:31:48.238;436;27;409;-1;
2025-08-07 14:31:48.737;436;27;409;-1;
2025-08-07 14:31:49.238;440;36;404;-1;
2025-08-07 14:31:49.738;440;36;404;-1;
2025-08-07 14:31:50.238;442;-3;445;-1;
2025-08-07 14:31:50.737;442;-3;445;-1;
2025-08-07 14:31:51.238;439;-138;577;-1;
2025-08-07 14:31:51.737;439;-138;577;-1;
2025-08-07 14:31:52.238;441;-185;626;-1;
2025-08-07 14:31:52.738;441;-185;626;-1;
2025-08-07 14:31:53.238;438;-199;637;-1;
2025-08-07 14:31:53.737;438;-199;637;-1;
2025-08-07 14:31:54.237;442;-171;613;-1;
2025-08-07 14:31:54.737;442;-171;613;-1;
2025-08-07 14:31:55.238;439;31;408;-1;
2025-08-07 14:31:55.737;439;31;408;-1;
2025-08-07 14:31:56.238;442;24;418;-1;
2025-08-07 14:31:56.737;442;24;418;-1;
2025-08-07 14:31:57.238;439;20;419;-1;
2025-08-07 14:31:57.738;439;20;419;-1;
2025-08-07 14:31:58.238;439;9;430;-1;
2025-08-07 14:31:58.737;439;9;430;-1;
2025-08-07 14:31:59.237;440;21;419;-1;
2025-08-07 14:31:59.738;440;21;419;-1;
2025-08-07 14:32:00.237;439;6;433;-1;
2025-08-07 14:32:00.737;439;6;433;-1;
2025-08-07 14:32:01.237;440;18;422;-1;
2025-08-07 14:32:01.737;440;18;422;-1;
2025-08-07 14:32:02.238;437;19;418;-1;
2025-08-07 14:32:02.737;437;19;418;-1;
2025-08-07 14:32:03.911;440;27;413;-1;
2025-08-07 14:32:04.238;441;21;420;-1;
2025-08-07 14:32:04.738;441;21;420;-1;
2025-08-07 14:32:05.237;436;-30;466;-1;
2025-08-07 14:32:05.737;436;-30;466;-1;
2025-08-07 14:32:06.238;438;-279;717;-1;
2025-08-07 14:32:06.737;438;-279;717;-1;
2025-08-07 14:32:07.237;439;-167;606;-1;
2025-08-07 14:32:07.737;439;-167;606;-1;
2025-08-07 14:32:08.237;440;-231;671;-1;
2025-08-07 14:32:08.737;440;-231;671;-1;
2025-08-07 14:32:09.238;439;-181;620;-1;
2025-08-07 14:32:09.737;439;-181;620;-1;
2025-08-07 14:32:10.237;439;15;424;-1;
2025-08-07 14:32:10.737;439;15;424;-1;
2025-08-07 14:32:11.237;440;12;428;-1;
2025-08-07 14:32:11.737;440;12;428;-1;
2025-08-07 14:32:12.237;439;-4;443;-1;
2025-08-07 14:32:12.737;439;-4;443;-1;
2025-08-07 14:32:13.240;441;12;429;-1;
2025-08-07 14:32:13.737;441;12;429;-1;
2025-08-07 14:32:14.237;439;15;424;-1;
2025-08-07 14:32:14.738;439;15;424;-1;
2025-08-07 14:32:15.237;440;6;434;-1;
2025-08-07 14:32:15.737;440;6;434;-1;
2025-08-07 14:32:16.237;441;14;427;-1;
2025-08-07 14:32:16.737;441;14;427;-1;
2025-08-07 14:32:17.237;439;13;426;-1;
2025-08-07 14:32:17.736;439;13;426;-1;
2025-08-07 14:32:18.237;442;19;423;-1;
2025-08-07 14:32:18.737;442;19;423;-1;
2025-08-07 14:32:19.237;436;17;419;-1;
2025-08-07 14:32:19.737;436;17;419;-1;
2025-08-07 14:32:20.237;436;-30;466;-1;
2025-08-07 14:32:20.938;436;-30;466;-1;
2025-08-07 14:32:21.268;439;-178;617;-1;
2025-08-07 14:32:21.882;439;-178;617;-1;
2025-08-07 14:32:22.343;439;-192;631;-1;
2025-08-07 14:32:22.763;439;-192;631;-1;
2025-08-07 14:32:23.325;438;-255;693;-1;
2025-08-07 14:32:23.737;438;-255;693;-1;
2025-08-07 14:32:24.237;437;-198;635;-1;
