time;solar;injection;conso;power_limit;delay
2025-08-07 14:44:58.708;1836;1355;481;-1;
2025-08-07 14:44:59.208;1836;1355;481;-1;
2025-08-07 14:44:59.709;1836;1342;494;-1;
2025-08-07 14:45:00.209;1836;1342;494;-1;
2025-08-07 14:45:00.708;1840;1547;293;-1;
2025-08-07 14:45:01.208;1840;1547;293;-1;
2025-08-07 14:45:01.709;1833;1541;292;-1;
2025-08-07 14:45:02.209;1833;1541;292;-1;
2025-08-07 14:45:02.708;1833;1540;293;-1;
2025-08-07 14:45:03.208;1833;1540;293;-1;
2025-08-07 14:45:03.709;1837;1560;277;-1;
2025-08-07 14:45:04.208;1837;1560;277;-1;
2025-08-07 14:45:04.708;1838;1558;280;-1;
2025-08-07 14:45:05.208;1838;1558;280;-1;
2025-08-07 14:45:05.709;1839;1321;518;-1;
2025-08-07 14:45:06.207;1839;1321;518;-1;
2025-08-07 14:45:06.708;1837;1336;501;-1;
2025-08-07 14:45:07.208;1837;1336;501;-1;
2025-08-07 14:45:07.708;1837;1402;435;-1;
2025-08-07 14:45:08.208;1837;1402;435;-1;
2025-08-07 14:45:08.708;1838;1307;531;-1;
2025-08-07 14:45:09.207;1838;1307;531;-1;
2025-08-07 14:45:09.708;1838;1287;551;-1;
2025-08-07 14:45:10.207;1838;1287;551;-1;
2025-08-07 14:45:10.709;1840;1174;666;-1;
2025-08-07 14:45:11.207;1840;1174;666;-1;
2025-08-07 14:45:11.708;1836;1297;539;-1;
2025-08-07 14:45:12.207;1836;1297;539;-1;
2025-08-07 14:45:12.708;1835;1316;519;-1;
2025-08-07 14:45:13.207;1835;1316;519;-1;
2025-08-07 14:45:13.708;1837;1316;521;-1;
2025-08-07 14:45:14.239;1837;1316;521;-1;
2025-08-07 14:45:14.708;1840;1368;472;-1;
2025-08-07 14:45:15.207;1840;1368;472;-1;
2025-08-07 14:45:15.707;1837;1533;304;-1;
2025-08-07 14:45:16.207;1837;1533;304;-1;
2025-08-07 14:45:16.707;1837;1537;300;-1;
2025-08-07 14:45:17.207;1837;1537;300;-1;
2025-08-07 14:45:17.708;1837;1525;312;-1;
2025-08-07 14:45:18.207;1837;1525;312;-1;
2025-08-07 14:45:18.708;1837;1531;306;-1;
2025-08-07 14:45:19.207;1837;1531;306;-1;
2025-08-07 14:45:19.707;1834;1534;300;-1;
2025-08-07 14:45:20.207;1834;1534;300;-1;
2025-08-07 14:45:20.707;1839;1350;489;-1;
2025-08-07 14:45:21.207;1839;1350;489;-1;
2025-08-07 14:45:21.707;1839;1404;435;-1;
2025-08-07 14:45:22.207;1839;1404;435;-1;
2025-08-07 14:45:22.707;1839;1288;551;-1;
2025-08-07 14:45:23.207;1839;1288;551;-1;
2025-08-07 14:45:23.707;1836;1312;524;-1;
2025-08-07 14:45:24.207;1836;1312;524;-1;
2025-08-07 14:45:24.420;9;write_maxlimit_Modbus. Ecriture Modbus de power_limit = 20% (valeur 200 écrite dans le registre 40189)
2025-08-07 14:45:24.672;9;write_maxlimit_Modbus. Fin d'exécution de la procédure
2025-08-07 14:45:24.722;1837;1277;560;-1;
2025-08-07 14:45:25.207;1837;1277;560;-1;
2025-08-07 14:45:25.707;1839;1283;556;-1;
2025-08-07 14:45:26.207;1839;1283;556;-1;
2025-08-07 14:45:26.708;1839;1269;570;-1;
2025-08-07 14:45:27.207;1839;1269;570;-1;
2025-08-07 14:45:27.707;1832;1314;518;-1;
2025-08-07 14:45:28.207;1832;1314;518;-1;
2025-08-07 14:45:28.707;1808;1284;524;-1;
2025-08-07 14:45:29.207;1808;1284;524;-1;
2025-08-07 14:45:29.707;1738;1227;511;-1;
2025-08-07 14:45:30.207;1738;1227;511;-1;
2025-08-07 14:45:30.707;1653;1355;298;-1;
2025-08-07 14:45:31.207;1653;1355;298;-1;
2025-08-07 14:45:31.707;1549;1248;301;-1;
2025-08-07 14:45:32.207;1549;1248;301;-1;
2025-08-07 14:45:32.707;1439;1147;292;-1;
2025-08-07 14:45:33.207;1439;1147;292;-1;
2025-08-07 14:45:33.707;1202;914;288;-1;
2025-08-07 14:45:34.206;1202;914;288;-1;
2025-08-07 14:45:34.707;984;691;293;-1;
2025-08-07 14:45:35.206;984;691;293;-1;
2025-08-07 14:45:35.708;911;406;505;-1;
2025-08-07 14:45:36.207;911;406;505;-1;
2025-08-07 14:45:36.707;842;334;508;-1;
2025-08-07 14:45:37.207;842;334;508;-1;
2025-08-07 14:45:37.706;650;223;427;-1;
2025-08-07 14:45:38.207;650;223;427;-1;
2025-08-07 14:45:38.707;488;-12;500;-1;
2025-08-07 14:45:39.206;488;-12;500;-1;
2025-08-07 14:45:39.707;463;-58;521;-1;
2025-08-07 14:45:40.206;463;-58;521;-1;
2025-08-07 14:45:40.706;438;-146;584;-1;
2025-08-07 14:45:41.206;438;-146;584;-1;
2025-08-07 14:45:41.706;414;-74;488;-1;
2025-08-07 14:45:42.206;414;-74;488;-1;
2025-08-07 14:45:42.706;393;-145;538;-1;
2025-08-07 14:45:43.206;393;-145;538;-1;
2025-08-07 14:45:43.706;371;-135;506;-1;
2025-08-07 14:45:44.206;371;-135;506;-1;
2025-08-07 14:45:44.706;305;-115;420;-1;
2025-08-07 14:45:45.206;305;-115;420;-1;
2025-08-07 14:45:45.706;265;-21;286;-1;
2025-08-07 14:45:46.206;265;-21;286;-1;
2025-08-07 14:45:46.706;242;-59;301;-1;
2025-08-07 14:45:47.206;242;-59;301;-1;
2025-08-07 14:45:47.706;220;-77;297;-1;
2025-08-07 14:45:48.246;220;-77;297;-1;
2025-08-07 14:45:48.859;201;-86;287;-1;
2025-08-07 14:45:49.206;201;-86;287;-1;
2025-08-07 14:45:49.781;192;-121;313;-1;
2025-08-07 14:45:50.395;192;-121;313;-1;
2025-08-07 14:45:50.725;196;-340;536;-1;
2025-08-07 14:45:51.337;196;-340;536;-1;
2025-08-07 14:45:51.707;190;-240;430;-1;
2025-08-07 14:45:52.206;190;-240;430;-1;
2025-08-07 14:45:52.707;192;-361;553;-1;
2025-08-07 14:45:53.206;192;-361;553;-1;
2025-08-07 14:45:53.706;192;-321;513;-1;
2025-08-07 14:45:54.206;192;-321;513;-1;
2025-08-07 14:45:54.706;194;-318;512;-1;
2025-08-07 14:45:55.206;194;-318;512;-1;
2025-08-07 14:45:55.705;194;-331;525;-1;
2025-08-07 14:45:56.205;194;-331;525;-1;
2025-08-07 14:45:56.706;194;-308;502;-1;
2025-08-07 14:45:57.206;194;-308;502;-1;
2025-08-07 14:45:57.706;193;-296;489;-1;
2025-08-07 14:45:58.205;193;-296;489;-1;
2025-08-07 14:45:58.706;194;-265;459;-1;
2025-08-07 14:45:59.206;194;-265;459;-1;
2025-08-07 14:45:59.706;196;-325;521;-1;
2025-08-07 14:46:00.205;196;-325;521;-1;
2025-08-07 14:46:00.706;191;-82;273;-1;
2025-08-07 14:46:01.205;191;-82;273;-1;
2025-08-07 14:46:01.705;193;-68;261;-1;
2025-08-07 14:46:02.206;193;-68;261;-1;
2025-08-07 14:46:02.706;194;-68;262;-1;
2025-08-07 14:46:03.205;194;-68;262;-1;
2025-08-07 14:46:03.706;196;-68;264;-1;
2025-08-07 14:46:04.206;196;-68;264;-1;
2025-08-07 14:46:04.706;192;-73;265;-1;
2025-08-07 14:46:05.205;192;-73;265;-1;
2025-08-07 14:46:05.705;193;-319;512;-1;
2025-08-07 14:46:06.206;193;-319;512;-1;
2025-08-07 14:46:06.705;194;-314;508;-1;
2025-08-07 14:46:07.205;194;-314;508;-1;
2025-08-07 14:46:07.706;193;-299;492;-1;
2025-08-07 14:46:08.205;193;-299;492;-1;
2025-08-07 14:46:08.705;193;-323;516;-1;
2025-08-07 14:46:09.205;193;-323;516;-1;
2025-08-07 14:46:09.706;197;-262;459;-1;
2025-08-07 14:46:10.205;197;-262;459;-1;
2025-08-07 14:46:10.705;196;-293;489;-1;
2025-08-07 14:46:11.205;196;-293;489;-1;
2025-08-07 14:46:11.705;194;-318;512;-1;
2025-08-07 14:46:12.115;9;write_maxlimit_Modbus. Ecriture Modbus de power_limit = 15% (valeur 150 écrite dans le registre 40189)
2025-08-07 14:46:12.205;194;-318;512;-1;
2025-08-07 14:46:12.447;9;write_maxlimit_Modbus. Fin d'exécution de la procédure
2025-08-07 14:46:12.705;195;-377;572;-1;
2025-08-07 14:46:13.205;195;-377;572;-1;
2025-08-07 14:46:13.705;191;-328;519;-1;
2025-08-07 14:46:14.205;191;-328;519;-1;
2025-08-07 14:46:14.706;197;-289;486;-1;
2025-08-07 14:46:15.205;197;-289;486;-1;
2025-08-07 14:46:15.706;184;-92;276;-1;
2025-08-07 14:46:16.205;184;-92;276;-1;
2025-08-07 14:46:16.705;170;-109;279;-1;
2025-08-07 14:46:17.205;170;-109;279;-1;
2025-08-07 14:46:17.705;158;-117;275;-1;
2025-08-07 14:46:18.205;158;-117;275;-1;
2025-08-07 14:46:18.705;148;-133;281;-1;
2025-08-07 14:46:19.204;148;-133;281;-1;
2025-08-07 14:46:19.706;147;-126;273;-1;
2025-08-07 14:46:20.205;147;-126;273;-1;
2025-08-07 14:46:20.705;148;-365;513;-1;
2025-08-07 14:46:21.205;148;-365;513;-1;
2025-08-07 14:46:21.705;149;-294;443;-1;
2025-08-07 14:46:22.205;149;-294;443;-1;
2025-08-07 14:46:22.705;147;-369;516;-1;
2025-08-07 14:46:23.205;147;-369;516;-1;
2025-08-07 14:46:23.705;146;-359;505;-1;
2025-08-07 14:46:24.205;146;-359;505;-1;
2025-08-07 14:46:24.705;149;-358;507;-1;
2025-08-07 14:46:25.205;149;-358;507;-1;
2025-08-07 14:46:25.705;147;-358;505;-1;
2025-08-07 14:46:26.204;147;-358;505;-1;
2025-08-07 14:46:26.705;147;-342;489;-1;
2025-08-07 14:46:27.205;147;-342;489;-1;
2025-08-07 14:46:27.705;149;-370;519;-1;
2025-08-07 14:46:28.205;149;-370;519;-1;
2025-08-07 14:46:28.704;146;-313;459;-1;
2025-08-07 14:46:29.204;146;-313;459;-1;
2025-08-07 14:46:29.705;145;-332;477;-1;
2025-08-07 14:46:30.204;145;-332;477;-1;
2025-08-07 14:46:30.705;147;-125;272;-1;
2025-08-07 14:46:31.204;147;-125;272;-1;
2025-08-07 14:46:31.704;146;-120;266;-1;
2025-08-07 14:46:32.204;146;-120;266;-1;
2025-08-07 14:46:32.705;147;-122;269;-1;
2025-08-07 14:46:33.204;147;-122;269;-1;
2025-08-07 14:46:33.704;147;-126;273;-1;
2025-08-07 14:46:34.204;147;-126;273;-1;
2025-08-07 14:46:34.704;147;-121;268;-1;
2025-08-07 14:46:35.205;147;-121;268;-1;
2025-08-07 14:46:35.705;147;-369;516;-1;
2025-08-07 14:46:36.205;147;-369;516;-1;
2025-08-07 14:46:36.704;149;-369;518;-1;
2025-08-07 14:46:37.204;149;-369;518;-1;
2025-08-07 14:46:37.705;146;-307;453;-1;
2025-08-07 14:46:38.204;146;-307;453;-1;
2025-08-07 14:46:38.704;149;-381;530;-1;
2025-08-07 14:46:39.204;149;-381;530;-1;
2025-08-07 14:46:39.705;145;-349;494;-1;
2025-08-07 14:46:40.204;145;-349;494;-1;
2025-08-07 14:46:40.704;149;-385;534;-1;
2025-08-07 14:46:41.204;149;-385;534;-1;
2025-08-07 14:46:41.707;151;-362;513;-1;
2025-08-07 14:46:42.204;151;-362;513;-1;
2025-08-07 14:46:42.708;151;-383;534;-1;
2025-08-07 14:46:43.204;151;-383;534;-1;
2025-08-07 14:46:43.714;149;-351;500;-1;
2025-08-07 14:46:44.028;9;write_maxlimit_Modbus. Ecriture Modbus de power_limit = 10% (valeur 100 écrite dans le registre 40189)
2025-08-07 14:46:44.204;149;-351;500;-1;
2025-08-07 14:46:44.269;9;write_maxlimit_Modbus. Fin d'exécution de la procédure
2025-08-07 14:46:44.704;148;-304;452;-1;
2025-08-07 14:46:45.204;148;-304;452;-1;
2025-08-07 14:46:45.704;146;-144;290;-1;
2025-08-07 14:46:46.204;146;-144;290;-1;
2025-08-07 14:46:46.705;151;-134;285;-1;
2025-08-07 14:46:47.203;151;-134;285;-1;
2025-08-07 14:46:47.704;148;-130;278;-1;
2025-08-07 14:46:48.204;148;-130;278;-1;
2025-08-07 14:46:48.704;150;-123;273;-1;
2025-08-07 14:46:49.204;150;-123;273;-1;
2025-08-07 14:46:49.704;146;-131;277;-1;
2025-08-07 14:46:50.204;146;-131;277;-1;
2025-08-07 14:46:50.704;147;-374;521;-1;
2025-08-07 14:46:51.204;147;-374;521;-1;
2025-08-07 14:46:51.704;141;-301;442;-1;
2025-08-07 14:46:52.205;141;-301;442;-1;
2025-08-07 14:46:52.704;130;-366;496;-1;
2025-08-07 14:46:53.203;130;-366;496;-1;
2025-08-07 14:46:53.704;120;-381;501;-1;
2025-08-07 14:46:54.203;120;-381;501;-1;
2025-08-07 14:46:54.704;110;-396;506;-1;
2025-08-07 14:46:55.203;110;-396;506;-1;
2025-08-07 14:46:55.703;101;-417;518;-1;
2025-08-07 14:46:56.204;101;-417;518;-1;
2025-08-07 14:46:56.791;101;-371;472;-1;
2025-08-07 14:46:57.406;101;-371;472;-1;
2025-08-07 14:46:57.704;101;-404;505;-1;
2025-08-07 14:46:58.287;101;-404;505;-1;
2025-08-07 14:46:58.704;100;-376;476;-1;
2025-08-07 14:46:59.205;100;-376;476;-1;
2025-08-07 14:46:59.824;100;-392;492;-1;
2025-08-07 14:47:00.204;100;-392;492;-1;
2025-08-07 14:47:00.704;100;-177;277;-1;
2025-08-07 14:47:01.203;100;-177;277;-1;
2025-08-07 14:47:01.703;101;-176;277;-1;
2025-08-07 14:47:02.203;101;-176;277;-1;
2025-08-07 14:47:02.704;100;-183;283;-1;
2025-08-07 14:47:03.204;100;-183;283;-1;
2025-08-07 14:47:03.704;101;-172;273;-1;
2025-08-07 14:47:04.203;101;-172;273;-1;
2025-08-07 14:47:04.706;102;-177;279;-1;
2025-08-07 14:47:05.203;102;-177;279;-1;
2025-08-07 14:47:05.704;101;-384;485;-1;
2025-08-07 14:47:06.204;101;-384;485;-1;
2025-08-07 14:47:06.703;99;-348;447;-1;
2025-08-07 14:47:07.203;99;-348;447;-1;
2025-08-07 14:47:07.704;100;-376;476;-1;
2025-08-07 14:47:08.203;100;-376;476;-1;
2025-08-07 14:47:08.703;102;-424;526;-1;
2025-08-07 14:47:09.204;102;-424;526;-1;
2025-08-07 14:47:09.704;98;-367;465;-1;
2025-08-07 14:47:10.203;98;-367;465;-1;
2025-08-07 14:47:10.703;103;-423;526;-1;
2025-08-07 14:47:11.203;103;-423;526;-1;
2025-08-07 14:47:11.703;99;-393;492;-1;
2025-08-07 14:47:12.205;99;-393;492;-1;
2025-08-07 14:47:12.703;102;-396;498;-1;
2025-08-07 14:47:13.203;102;-396;498;-1;
2025-08-07 14:47:13.703;102;-388;490;-1;
2025-08-07 14:47:14.203;102;-388;490;-1;
2025-08-07 14:47:14.703;101;-327;428;-1;
2025-08-07 14:47:15.203;101;-327;428;-1;
2025-08-07 14:47:15.703;100;-182;282;-1;
2025-08-07 14:47:16.203;100;-182;282;-1;
2025-08-07 14:47:16.703;100;-186;286;-1;
2025-08-07 14:47:17.203;100;-186;286;-1;
2025-08-07 14:47:17.703;101;-188;289;-1;
2025-08-07 14:47:18.205;101;-188;289;-1;
2025-08-07 14:47:18.703;98;-195;293;-1;
2025-08-07 14:47:19.203;98;-195;293;-1;
2025-08-07 14:47:19.703;99;-199;298;-1;
2025-08-07 14:47:20.202;99;-199;298;-1;
2025-08-07 14:47:20.703;100;-360;460;-1;
2025-08-07 14:47:21.203;100;-360;460;-1;
2025-08-07 14:47:21.703;100;-323;423;-1;
2025-08-07 14:47:22.143;9;write_maxlimit_Modbus. Ecriture Modbus de power_limit = 15% (valeur 150 écrite dans le registre 40189)
2025-08-07 14:47:22.202;100;-323;423;-1;
2025-08-07 14:47:22.302;9;write_maxlimit_Modbus. Fin d'exécution de la procédure
2025-08-07 14:47:22.703;100;-442;542;-1;
2025-08-07 14:47:23.202;100;-442;542;-1;
2025-08-07 14:47:23.703;100;-432;532;-1;
2025-08-07 14:47:24.202;100;-432;532;-1;
2025-08-07 14:47:24.702;100;-454;554;-1;
2025-08-07 14:47:25.203;100;-454;554;-1;
2025-08-07 14:47:25.702;100;-445;545;-1;
2025-08-07 14:47:26.203;100;-445;545;-1;
2025-08-07 14:47:26.702;102;-450;552;-1;
2025-08-07 14:47:27.203;102;-450;552;-1;
2025-08-07 14:47:27.703;149;-357;506;-1;
2025-08-07 14:47:28.202;149;-357;506;-1;
2025-08-07 14:47:28.703;149;-342;491;-1;
2025-08-07 14:47:29.202;149;-342;491;-1;
2025-08-07 14:47:29.703;150;-347;497;-1;
2025-08-07 14:47:30.212;150;-347;497;-1;
2025-08-07 14:47:30.702;146;-162;308;-1;
2025-08-07 14:47:31.202;146;-162;308;-1;
2025-08-07 14:47:31.702;151;-147;298;-1;
2025-08-07 14:47:32.202;151;-147;298;-1;
2025-08-07 14:47:32.702;150;-176;326;-1;
2025-08-07 14:47:33.203;150;-176;326;-1;
2025-08-07 14:47:33.702;148;-145;293;-1;
2025-08-07 14:47:34.202;148;-145;293;-1;
2025-08-07 14:47:34.702;150;-172;322;-1;
2025-08-07 14:47:35.202;150;-172;322;-1;
2025-08-07 14:47:35.702;148;-415;563;-1;
2025-08-07 14:47:36.202;148;-415;563;-1;
2025-08-07 14:47:36.703;151;-376;527;-1;
2025-08-07 14:47:37.203;151;-376;527;-1;
2025-08-07 14:47:37.703;147;-327;474;-1;
2025-08-07 14:47:38.202;147;-327;474;-1;
2025-08-07 14:47:38.702;149;-413;562;-1;
2025-08-07 14:47:39.202;149;-413;562;-1;
2025-08-07 14:47:39.702;148;-353;501;-1;
2025-08-07 14:47:40.202;148;-353;501;-1;
2025-08-07 14:47:40.702;148;-387;535;-1;
2025-08-07 14:47:41.203;148;-387;535;-1;
2025-08-07 14:47:41.702;150;-361;511;-1;
2025-08-07 14:47:42.202;150;-361;511;-1;
2025-08-07 14:47:42.702;146;-403;549;-1;
2025-08-07 14:47:43.202;146;-403;549;-1;
2025-08-07 14:47:43.702;149;-354;503;-1;
2025-08-07 14:47:44.201;149;-354;503;-1;
2025-08-07 14:47:44.702;146;-334;480;-1;
2025-08-07 14:47:45.202;146;-334;480;-1;
2025-08-07 14:47:45.701;150;-141;291;-1;
2025-08-07 14:47:46.202;150;-141;291;-1;
2025-08-07 14:47:46.702;144;-155;299;-1;
2025-08-07 14:47:47.201;144;-155;299;-1;
2025-08-07 14:47:47.702;150;-143;293;-1;
2025-08-07 14:47:48.201;150;-143;293;-1;
2025-08-07 14:47:48.701;150;-144;294;-1;
2025-08-07 14:47:49.202;150;-144;294;-1;
2025-08-07 14:47:49.702;147;-136;283;-1;
2025-08-07 14:47:50.201;147;-136;283;-1;
2025-08-07 14:47:50.702;148;-425;573;-1;
2025-08-07 14:47:51.201;148;-425;573;-1;
2025-08-07 14:47:51.702;146;-342;488;-1;
2025-08-07 14:47:52.201;146;-342;488;-1;
2025-08-07 14:47:52.701;147;-405;552;-1;
2025-08-07 14:47:53.205;147;-405;552;-1;
2025-08-07 14:47:53.702;148;-356;504;-1;
2025-08-07 14:47:54.201;148;-356;504;-1;
2025-08-07 14:47:54.702;147;-398;545;-1;
2025-08-07 14:47:55.202;147;-398;545;-1;
2025-08-07 14:47:55.701;147;-380;527;-1;
2025-08-07 14:47:56.201;147;-380;527;-1;
2025-08-07 14:47:56.701;147;-364;511;-1;
2025-08-07 14:47:57.201;147;-364;511;-1;
2025-08-07 14:47:57.701;148;-353;501;-1;
2025-08-07 14:47:58.201;148;-353;501;-1;
2025-08-07 14:47:58.706;147;-342;489;-1;
2025-08-07 14:47:58.884;9;write_maxlimit_Modbus. Ecriture Modbus de power_limit = 20% (valeur 200 écrite dans le registre 40189)
2025-08-07 14:47:59.066;9;write_maxlimit_Modbus. Fin d'exécution de la procédure
2025-08-07 14:47:59.201;147;-342;489;-1;
2025-08-07 14:47:59.702;148;-346;494;-1;
2025-08-07 14:48:00.202;148;-346;494;-1;
2025-08-07 14:48:00.703;170;-133;303;-1;
2025-08-07 14:48:01.201;170;-133;303;-1;
2025-08-07 14:48:01.701;198;-110;308;-1;
2025-08-07 14:48:02.201;198;-110;308;-1;
2025-08-07 14:48:02.701;194;-111;305;-1;
2025-08-07 14:48:03.201;194;-111;305;-1;
2025-08-07 14:48:03.709;194;-107;301;-1;
2025-08-07 14:48:04.201;194;-107;301;-1;
2025-08-07 14:48:04.701;195;-107;302;-1;
2025-08-07 14:48:05.298;195;-107;302;-1;
2025-08-07 14:48:05.912;192;-323;515;-1;
2025-08-07 14:48:06.201;192;-323;515;-1;
2025-08-07 14:48:06.793;193;-321;514;-1;
2025-08-07 14:48:07.202;193;-321;514;-1;
2025-08-07 14:48:07.711;194;-313;507;-1;
2025-08-07 14:48:08.329;194;-313;507;-1;
2025-08-07 14:48:08.702;193;-376;569;-1;
2025-08-07 14:48:09.201;193;-376;569;-1;
2025-08-07 14:48:09.701;193;-320;513;-1;
2025-08-07 14:48:10.201;193;-320;513;-1;
2025-08-07 14:48:10.701;193;-365;558;-1;
2025-08-07 14:48:11.201;193;-365;558;-1;
2025-08-07 14:48:11.701;194;-341;535;-1;
2025-08-07 14:48:12.200;194;-341;535;-1;
2025-08-07 14:48:12.700;193;-316;509;-1;
2025-08-07 14:48:13.200;193;-316;509;-1;
2025-08-07 14:48:13.701;196;-318;514;-1;
2025-08-07 14:48:14.203;196;-318;514;-1;
2025-08-07 14:48:14.701;191;-292;483;-1;
2025-08-07 14:48:15.201;191;-292;483;-1;
2025-08-07 14:48:15.701;197;-100;297;-1;
2025-08-07 14:48:16.200;197;-100;297;-1;
2025-08-07 14:48:16.700;192;-105;297;-1;
2025-08-07 14:48:17.201;192;-105;297;-1;
2025-08-07 14:48:17.701;193;-125;318;-1;
2025-08-07 14:48:18.200;193;-125;318;-1;
2025-08-07 14:48:18.700;193;-111;304;-1;
2025-08-07 14:48:19.201;193;-111;304;-1;
2025-08-07 14:48:19.701;195;-90;285;-1;
2025-08-07 14:48:20.200;195;-90;285;-1;
2025-08-07 14:48:20.700;191;-380;571;-1;
2025-08-07 14:48:21.200;191;-380;571;-1;
2025-08-07 14:48:21.701;193;-339;532;-1;
2025-08-07 14:48:22.201;193;-339;532;-1;
2025-08-07 14:48:22.700;193;-350;543;-1;
2025-08-07 14:48:23.201;193;-350;543;-1;
2025-08-07 14:48:23.701;193;-342;535;-1;
2025-08-07 14:48:24.200;193;-342;535;-1;
2025-08-07 14:48:24.700;191;-350;541;-1;
2025-08-07 14:48:25.201;191;-350;541;-1;
2025-08-07 14:48:25.701;192;-299;491;-1;
2025-08-07 14:48:26.200;192;-299;491;-1;
2025-08-07 14:48:26.701;192;-303;495;-1;
2025-08-07 14:48:27.200;192;-303;495;-1;
2025-08-07 14:48:27.701;198;-274;472;-1;
2025-08-07 14:48:28.200;198;-274;472;-1;
2025-08-07 14:48:28.700;194;-250;444;-1;
2025-08-07 14:48:29.200;194;-250;444;-1;
2025-08-07 14:48:29.700;194;-265;459;-1;
2025-08-07 14:48:30.200;194;-265;459;-1;
2025-08-07 14:48:30.700;194;-57;251;-1;
2025-08-07 14:48:31.200;194;-57;251;-1;
2025-08-07 14:48:31.700;192;-60;252;-1;
2025-08-07 14:48:32.200;192;-60;252;-1;
2025-08-07 14:48:32.700;193;-59;252;-1;
2025-08-07 14:48:33.200;193;-59;252;-1;
2025-08-07 14:48:33.700;195;-55;250;-1;
2025-08-07 14:48:34.200;195;-55;250;-1;
2025-08-07 14:48:34.700;195;-57;252;-1;
2025-08-07 14:48:35.200;195;-57;252;-1;
2025-08-07 14:48:35.700;192;-264;456;-1;
2025-08-07 14:48:36.200;192;-264;456;-1;
2025-08-07 14:48:36.700;193;-282;475;-1;
2025-08-07 14:48:37.200;193;-282;475;-1;
2025-08-07 14:48:37.700;193;-213;406;-1;
2025-08-07 14:48:38.199;193;-213;406;-1;
2025-08-07 14:48:38.700;194;-391;585;-1;
2025-08-07 14:48:39.200;194;-391;585;-1;
2025-08-07 14:48:39.700;195;-361;556;-1;
2025-08-07 14:48:40.199;195;-361;556;-1;
2025-08-07 14:48:40.700;197;-411;608;-1;
2025-08-07 14:48:41.200;197;-411;608;-1;
2025-08-07 14:48:41.700;195;-371;566;-1;
2025-08-07 14:48:42.200;195;-371;566;-1;
2025-08-07 14:48:42.699;197;-359;556;-1;
2025-08-07 14:48:43.199;197;-359;556;-1;
2025-08-07 14:48:43.699;200;-362;562;-1;
2025-08-07 14:48:44.204;200;-362;562;-1;
2025-08-07 14:48:44.700;194;-331;525;-1;
2025-08-07 14:48:45.199;194;-331;525;-1;
2025-08-07 14:48:45.700;191;-167;358;-1;
2025-08-07 14:48:46.199;191;-167;358;-1;
2025-08-07 14:48:46.699;196;-153;349;-1;
2025-08-07 14:48:47.200;196;-153;349;-1;
2025-08-07 14:48:47.699;196;-55;251;-1;
2025-08-07 14:48:48.199;196;-55;251;-1;
2025-08-07 14:48:48.700;193;-58;251;-1;
2025-08-07 14:48:49.199;193;-58;251;-1;
2025-08-07 14:48:49.700;191;-60;251;-1;
2025-08-07 14:48:50.199;191;-60;251;-1;
2025-08-07 14:48:50.699;197;-338;535;-1;
2025-08-07 14:48:51.199;197;-338;535;-1;
2025-08-07 14:48:51.700;195;-314;509;-1;
2025-08-07 14:48:52.199;195;-314;509;-1;
2025-08-07 14:48:52.699;192;-318;510;-1;
2025-08-07 14:48:53.199;192;-318;510;-1;
2025-08-07 14:48:53.699;193;-241;434;-1;
2025-08-07 14:48:54.199;193;-241;434;-1;
2025-08-07 14:48:54.700;193;-288;481;-1;
2025-08-07 14:48:55.199;193;-288;481;-1;
2025-08-07 14:48:55.700;193;-349;542;-1;
2025-08-07 14:48:56.199;193;-349;542;-1;
2025-08-07 14:48:56.699;194;-306;500;-1;
2025-08-07 14:48:57.199;194;-306;500;-1;
2025-08-07 14:48:57.699;194;-300;494;-1;
2025-08-07 14:48:58.199;194;-300;494;-1;
2025-08-07 14:48:58.699;192;-294;486;-1;
2025-08-07 14:48:59.199;192;-294;486;-1;
2025-08-07 14:48:59.699;194;-282;476;-1;
2025-08-07 14:49:00.199;194;-282;476;-1;
2025-08-07 14:49:00.699;194;-56;250;-1;
