time;solar;injection;conso;power_limit;delay
2025-08-07 14:14:16.777;1839;1348;491;-1;
2025-08-07 14:14:17.278;1841;1396;445;-1;
2025-08-07 14:14:17.777;1841;1396;445;-1;
2025-08-07 14:14:18.277;1840;1408;432;-1;
2025-08-07 14:14:18.777;1840;1408;432;-1;
2025-08-07 14:14:19.277;1837;1386;451;-1;
2025-08-07 14:14:19.778;1837;1386;451;-1;
2025-08-07 14:14:20.278;1840;1431;409;-1;
2025-08-07 14:14:20.777;1840;1431;409;-1;
2025-08-07 14:14:21.278;1837;1388;449;-1;
2025-08-07 14:14:21.777;1837;1388;449;-1;
2025-08-07 14:14:22.277;1836;1394;442;-1;
2025-08-07 14:14:22.777;1836;1394;442;-1;
2025-08-07 14:14:23.278;1838;1377;461;-1;
2025-08-07 14:14:23.777;1838;1377;461;-1;
2025-08-07 14:14:24.278;1838;1576;262;-1;
2025-08-07 14:14:24.777;1838;1576;262;-1;
2025-08-07 14:14:25.278;1835;1586;249;-1;
2025-08-07 14:14:25.777;1835;1586;249;-1;
2025-08-07 14:14:26.277;1841;1596;245;-1;
2025-08-07 14:14:26.777;1841;1596;245;-1;
2025-08-07 14:14:27.277;1837;1592;245;-1;
2025-08-07 14:14:27.777;1837;1592;245;-1;
2025-08-07 14:14:27.890;9;write_maxlimit_Modbus. Ecriture Modbus de power_limit = 50% (valeur 500 écrite dans le registre 40189)
2025-08-07 14:14:28.045;9;write_maxlimit_Modbus. Fin d'exécution de la procédure
2025-08-07 14:14:28.277;1838;1572;266;-1;
2025-08-07 14:14:28.776;1838;1572;266;-1;
2025-08-07 14:14:29.276;1836;1566;270;-1;
2025-08-07 14:14:29.777;1836;1566;270;-1;
2025-08-07 14:14:30.277;1832;1369;463;-1;
2025-08-07 14:14:30.777;1832;1369;463;-1;
2025-08-07 14:14:31.277;1799;1323;476;-1;
2025-08-07 14:14:31.777;1799;1323;476;-1;
2025-08-07 14:14:32.277;1741;1281;460;-1;
2025-08-07 14:14:32.776;1741;1281;460;-1;
2025-08-07 14:14:33.277;1690;1263;427;-1;
2025-08-07 14:14:33.777;1690;1263;427;-1;
2025-08-07 14:14:34.277;1624;1185;439;-1;
2025-08-07 14:14:34.776;1624;1185;439;-1;
2025-08-07 14:14:35.277;1553;1124;429;-1;
2025-08-07 14:14:35.776;1553;1124;429;-1;
2025-08-07 14:14:36.276;1493;1068;425;-1;
2025-08-07 14:14:36.776;1493;1068;425;-1;
2025-08-07 14:14:37.277;1469;1017;452;-1;
2025-08-07 14:14:37.777;1469;1017;452;-1;
2025-08-07 14:14:38.276;1444;980;464;-1;
2025-08-07 14:14:38.778;1444;980;464;-1;
2025-08-07 14:14:39.278;1419;1158;261;-1;
2025-08-07 14:14:39.777;1419;1158;261;-1;
2025-08-07 14:14:40.277;1393;1148;245;-1;
2025-08-07 14:14:40.776;1393;1148;245;-1;
2025-08-07 14:14:41.276;1367;1114;253;-1;
2025-08-07 14:14:41.776;1367;1114;253;-1;
2025-08-07 14:14:42.276;1355;1112;243;-1;
2025-08-07 14:14:42.780;1355;1112;243;-1;
2025-08-07 14:14:43.277;1352;1116;236;-1;
2025-08-07 14:14:43.776;1352;1116;236;-1;
2025-08-07 14:14:44.276;1354;1113;241;-1;
2025-08-07 14:14:44.776;1354;1113;241;-1;
2025-08-07 14:14:45.277;1354;905;449;-1;
2025-08-07 14:14:45.776;1354;905;449;-1;
2025-08-07 14:14:46.276;1353;886;467;-1;
2025-08-07 14:14:46.776;1353;886;467;-1;
2025-08-07 14:14:47.276;1354;910;444;-1;
2025-08-07 14:14:47.776;1354;910;444;-1;
2025-08-07 14:14:48.276;1355;942;413;-1;
2025-08-07 14:14:48.780;1355;942;413;-1;
2025-08-07 14:14:49.276;1354;904;450;-1;
2025-08-07 14:14:49.776;1354;904;450;-1;
2025-08-07 14:14:50.276;1354;921;433;-1;
2025-08-07 14:14:50.776;1354;921;433;-1;
2025-08-07 14:14:51.277;1358;870;488;-1;
2025-08-07 14:14:51.874;1358;870;488;-1;
2025-08-07 14:14:52.461;1353;911;442;-1;
2025-08-07 14:14:52.776;1353;911;442;-1;
2025-08-07 14:14:53.362;1356;893;463;-1;
2025-08-07 14:14:53.977;1356;893;463;-1;
2025-08-07 14:14:54.284;1356;1090;266;-1;
2025-08-07 14:14:54.897;1356;1090;266;-1;
2025-08-07 14:14:55.276;1354;1103;251;-1;
2025-08-07 14:14:55.819;1354;1103;251;-1;
2025-08-07 14:14:56.318;1355;1104;251;-1;
2025-08-07 14:14:56.775;1355;1104;251;-1;
2025-08-07 14:14:57.276;1356;1105;251;-1;
2025-08-07 14:14:57.776;1356;1105;251;-1;
2025-08-07 14:14:58.276;1355;1106;249;-1;
2025-08-07 14:14:58.775;1355;1106;249;-1;
2025-08-07 14:14:59.276;1355;1096;259;-1;
2025-08-07 14:14:59.776;1355;1096;259;-1;
2025-08-07 14:15:00.276;1355;865;490;-1;
2025-08-07 14:15:00.776;1355;865;490;-1;
2025-08-07 14:15:01.275;1355;887;468;-1;
2025-08-07 14:15:01.775;1355;887;468;-1;
2025-08-07 14:15:02.275;1356;893;463;-1;
2025-08-07 14:15:02.775;1356;893;463;-1;
2025-08-07 14:15:03.276;1357;906;451;-1;
2025-08-07 14:15:03.776;1357;906;451;-1;
2025-08-07 14:15:04.276;1357;896;461;-1;
2025-08-07 14:15:04.776;1357;896;461;-1;
2025-08-07 14:15:05.276;1355;919;436;-1;
2025-08-07 14:15:05.775;1355;919;436;-1;
2025-08-07 14:15:06.275;1358;914;444;-1;
2025-08-07 14:15:06.775;1358;914;444;-1;
2025-08-07 14:15:07.276;1355;922;433;-1;
2025-08-07 14:15:07.775;1355;922;433;-1;
2025-08-07 14:15:08.276;1356;1096;260;-1;
2025-08-07 14:15:08.775;1356;1096;260;-1;
2025-08-07 14:15:09.275;1353;1100;253;-1;
2025-08-07 14:15:09.775;1353;1100;253;-1;
2025-08-07 14:15:10.217;9;write_maxlimit_Modbus. Ecriture Modbus de power_limit = 30% (valeur 300 écrite dans le registre 40189)
2025-08-07 14:15:10.276;1352;1082;270;-1;
2025-08-07 14:15:10.373;9;write_maxlimit_Modbus. Fin d'exécution de la procédure
2025-08-07 14:15:10.776;1352;1082;270;-1;
2025-08-07 14:15:11.275;1356;1096;260;-1;
2025-08-07 14:15:11.776;1356;1096;260;-1;
2025-08-07 14:15:12.275;1358;1105;253;-1;
2025-08-07 14:15:12.776;1358;1105;253;-1;
2025-08-07 14:15:13.275;1352;1086;266;-1;
2025-08-07 14:15:13.775;1352;1086;266;-1;
2025-08-07 14:15:14.276;1355;1101;254;-1;
2025-08-07 14:15:14.775;1355;1101;254;-1;
2025-08-07 14:15:15.275;1358;893;465;-1;
2025-08-07 14:15:15.775;1358;893;465;-1;
2025-08-07 14:15:16.275;1340;871;469;-1;
2025-08-07 14:15:16.775;1340;871;469;-1;
2025-08-07 14:15:17.275;1302;865;437;-1;
2025-08-07 14:15:17.775;1302;865;437;-1;
2025-08-07 14:15:18.275;1244;784;460;-1;
2025-08-07 14:15:18.774;1244;784;460;-1;
2025-08-07 14:15:19.274;1138;712;426;-1;
2025-08-07 14:15:19.775;1138;712;426;-1;
2025-08-07 14:15:20.275;1036;568;468;-1;
2025-08-07 14:15:20.774;1036;568;468;-1;
2025-08-07 14:15:21.275;885;423;462;-1;
2025-08-07 14:15:21.774;885;423;462;-1;
2025-08-07 14:15:22.275;550;90;460;-1;
2025-08-07 14:15:22.774;550;90;460;-1;
2025-08-07 14:15:23.274;284;-159;443;-1;
2025-08-07 14:15:23.774;284;-159;443;-1;
2025-08-07 14:15:24.275;286;-130;416;-1;
2025-08-07 14:15:24.775;286;-130;416;-1;
2025-08-07 14:15:25.275;290;40;250;-1;
2025-08-07 14:15:25.774;290;40;250;-1;
2025-08-07 14:15:26.275;285;23;262;-1;
2025-08-07 14:15:26.774;285;23;262;-1;
2025-08-07 14:15:27.274;286;38;248;-1;
2025-08-07 14:15:27.774;286;38;248;-1;
2025-08-07 14:15:28.275;285;33;252;-1;
2025-08-07 14:15:28.775;285;33;252;-1;
2025-08-07 14:15:29.274;284;35;249;-1;
2025-08-07 14:15:29.775;284;35;249;-1;
2025-08-07 14:15:30.274;284;-171;455;-1;
2025-08-07 14:15:30.775;284;-171;455;-1;
2025-08-07 14:15:31.275;285;-95;380;-1;
2025-08-07 14:15:31.774;285;-95;380;-1;
2025-08-07 14:15:32.275;285;-170;455;-1;
2025-08-07 14:15:32.774;285;-170;455;-1;
2025-08-07 14:15:33.275;286;-106;392;-1;
2025-08-07 14:15:33.774;286;-106;392;-1;
2025-08-07 14:15:34.275;284;-185;469;-1;
2025-08-07 14:15:34.775;284;-185;469;-1;
2025-08-07 14:15:35.274;285;-193;478;-1;
2025-08-07 14:15:35.774;285;-193;478;-1;
2025-08-07 14:15:36.275;283;-156;439;-1;
2025-08-07 14:15:36.774;283;-156;439;-1;
2025-08-07 14:15:37.274;284;-146;430;-1;
2025-08-07 14:15:37.774;284;-146;430;-1;
2025-08-07 14:15:38.274;287;-130;417;-1;
2025-08-07 14:15:38.774;287;-130;417;-1;
2025-08-07 14:15:39.275;284;-153;437;-1;
2025-08-07 14:15:39.774;284;-153;437;-1;
2025-08-07 14:15:40.274;286;36;250;-1;
2025-08-07 14:15:40.774;286;36;250;-1;
2025-08-07 14:15:41.274;285;36;249;-1;
2025-08-07 14:15:41.774;285;36;249;-1;
2025-08-07 14:15:42.274;284;35;249;-1;
2025-08-07 14:15:42.774;284;35;249;-1;
2025-08-07 14:15:43.274;284;34;250;-1;
2025-08-07 14:15:43.774;284;34;250;-1;
2025-08-07 14:15:44.274;286;36;250;-1;
2025-08-07 14:15:44.774;286;36;250;-1;
2025-08-07 14:15:45.275;287;-157;444;-1;
2025-08-07 14:15:45.774;287;-157;444;-1;
2025-08-07 14:15:46.274;281;-178;459;-1;
2025-08-07 14:15:46.774;281;-178;459;-1;
2025-08-07 14:15:47.275;285;-122;407;-1;
2025-08-07 14:15:47.774;285;-122;407;-1;
2025-08-07 14:15:48.274;284;-150;434;-1;
2025-08-07 14:15:48.773;284;-150;434;-1;
2025-08-07 14:15:49.274;286;-123;409;-1;
2025-08-07 14:15:49.773;286;-123;409;-1;
2025-08-07 14:15:50.274;286;-178;464;-1;
2025-08-07 14:15:50.773;286;-178;464;-1;
2025-08-07 14:15:51.274;284;-167;451;-1;
2025-08-07 14:15:51.773;284;-167;451;-1;
2025-08-07 14:15:52.273;284;-161;445;-1;
2025-08-07 14:15:52.774;284;-161;445;-1;
2025-08-07 14:15:53.273;287;-126;413;-1;
2025-08-07 14:15:53.773;287;-126;413;-1;
2025-08-07 14:15:54.274;287;-87;374;-1;
2025-08-07 14:15:54.774;287;-87;374;-1;
2025-08-07 14:15:55.275;284;58;226;-1;
2025-08-07 14:15:55.773;284;58;226;-1;
2025-08-07 14:15:56.273;283;56;227;-1;
2025-08-07 14:15:56.774;283;56;227;-1;
2025-08-07 14:15:57.274;284;54;230;-1;
2025-08-07 14:15:57.773;284;54;230;-1;
2025-08-07 14:15:58.273;285;54;231;-1;
2025-08-07 14:15:58.773;285;54;231;-1;
2025-08-07 14:15:59.273;283;51;232;-1;
2025-08-07 14:15:59.773;283;51;232;-1;
2025-08-07 14:16:00.274;287;-165;452;-1;
2025-08-07 14:16:00.842;287;-165;452;-1;
2025-08-07 14:16:01.273;282;-101;383;-1;
2025-08-07 14:16:01.907;282;-101;383;-1;
2025-08-07 14:16:02.370;287;-154;441;-1;
2025-08-07 14:16:02.789;287;-154;441;-1;
2025-08-07 14:16:03.458;285;-143;428;-1;
2025-08-07 14:16:03.710;9;write_maxlimit_Modbus. Ecriture Modbus de power_limit = 10% (valeur 100 écrite dans le registre 40189)
2025-08-07 14:16:03.775;285;-143;428;-1;
2025-08-07 14:16:04.063;9;write_maxlimit_Modbus. Fin d'exécution de la procédure
2025-08-07 14:16:04.327;285;-138;423;-1;
2025-08-07 14:16:04.962;285;-138;423;-1;
2025-08-07 14:16:05.273;283;-151;434;-1;
2025-08-07 14:16:05.772;283;-151;434;-1;
2025-08-07 14:16:06.274;272;-189;461;-1;
2025-08-07 14:16:06.773;272;-189;461;-1;
2025-08-07 14:16:07.273;249;-192;441;-1;
2025-08-07 14:16:07.773;249;-192;441;-1;
2025-08-07 14:16:08.273;228;-181;409;-1;
2025-08-07 14:16:08.773;228;-181;409;-1;
2025-08-07 14:16:09.274;209;-2063;2272;-1;
2025-08-07 14:16:09.773;209;-2063;2272;-1;
2025-08-07 14:16:10.273;191;-2078;2269;-1;
2025-08-07 14:16:10.773;191;-2078;2269;-1;
2025-08-07 14:16:11.274;176;-2090;2266;-1;
2025-08-07 14:16:11.773;176;-2090;2266;-1;
2025-08-07 14:16:12.273;164;-2106;2270;-1;
2025-08-07 14:16:12.773;164;-2106;2270;-1;
2025-08-07 14:16:13.274;152;-2117;2269;-1;
2025-08-07 14:16:13.773;152;-2117;2269;-1;
2025-08-07 14:16:14.274;140;-2130;2270;-1;
2025-08-07 14:16:14.773;140;-2130;2270;-1;
2025-08-07 14:16:15.273;129;-2268;2397;-1;
2025-08-07 14:16:15.773;129;-2268;2397;-1;
2025-08-07 14:16:16.273;119;-2352;2471;-1;
2025-08-07 14:16:16.772;119;-2352;2471;-1;
2025-08-07 14:16:17.273;109;-2368;2477;-1;
2025-08-07 14:16:17.773;109;-2368;2477;-1;
2025-08-07 14:16:18.273;101;-2337;2438;-1;
2025-08-07 14:16:18.772;101;-2337;2438;-1;
2025-08-07 14:16:19.272;101;-2347;2448;-1;
2025-08-07 14:16:19.773;101;-2347;2448;-1;
2025-08-07 14:16:20.272;100;-2315;2415;-1;
2025-08-07 14:16:20.772;100;-2315;2415;-1;
2025-08-07 14:16:21.272;101;-2315;2416;-1;
2025-08-07 14:16:21.772;101;-2315;2416;-1;
2025-08-07 14:16:22.273;100;-2371;2471;-1;
2025-08-07 14:16:22.772;100;-2371;2471;-1;
2025-08-07 14:16:23.272;98;-2357;2455;-1;
2025-08-07 14:16:23.773;98;-2357;2455;-1;
2025-08-07 14:16:24.272;100;-2356;2456;-1;
2025-08-07 14:16:24.772;100;-2356;2456;-1;
2025-08-07 14:16:25.272;102;-2159;2261;-1;
2025-08-07 14:16:25.772;102;-2159;2261;-1;
2025-08-07 14:16:26.273;101;-2160;2261;-1;
2025-08-07 14:16:26.772;101;-2160;2261;-1;
2025-08-07 14:16:27.273;101;-2140;2241;-1;
2025-08-07 14:16:27.772;101;-2140;2241;-1;
2025-08-07 14:16:28.272;100;-2139;2239;-1;
2025-08-07 14:16:28.773;100;-2139;2239;-1;
2025-08-07 14:16:29.273;101;-2142;2243;-1;
2025-08-07 14:16:29.772;101;-2142;2243;-1;
2025-08-07 14:16:30.272;101;-2243;2344;-1;
2025-08-07 14:16:30.772;101;-2243;2344;-1;
2025-08-07 14:16:31.273;100;-2394;2494;-1;
2025-08-07 14:16:31.773;100;-2394;2494;-1;
2025-08-07 14:16:32.272;99;-2299;2398;-1;
2025-08-07 14:16:32.772;99;-2299;2398;-1;
2025-08-07 14:16:33.272;98;-2340;2438;-1;
2025-08-07 14:16:33.772;98;-2340;2438;-1;
2025-08-07 14:16:34.272;101;-2310;2411;-1;
2025-08-07 14:16:34.773;101;-2310;2411;-1;
2025-08-07 14:16:35.272;100;-2327;2427;-1;
2025-08-07 14:16:35.774;100;-2327;2427;-1;
2025-08-07 14:16:36.272;100;-2333;2433;-1;
2025-08-07 14:16:36.772;100;-2333;2433;-1;
2025-08-07 14:16:37.272;101;-2338;2439;-1;
2025-08-07 14:16:37.779;101;-2338;2439;-1;
2025-08-07 14:16:38.272;99;-2311;2410;-1;
2025-08-07 14:16:38.772;99;-2311;2410;-1;
2025-08-07 14:16:39.272;102;-2335;2437;-1;
2025-08-07 14:16:39.772;102;-2335;2437;-1;
2025-08-07 14:16:40.272;102;-2148;2250;-1;
2025-08-07 14:16:40.771;102;-2148;2250;-1;
2025-08-07 14:16:41.272;101;-2147;2248;-1;
2025-08-07 14:16:41.771;101;-2147;2248;-1;
2025-08-07 14:16:42.272;99;-2158;2257;-1;
2025-08-07 14:16:42.772;99;-2158;2257;-1;
2025-08-07 14:16:43.271;100;-2144;2244;-1;
2025-08-07 14:16:43.772;100;-2144;2244;-1;
2025-08-07 14:16:44.272;100;-2148;2248;-1;
2025-08-07 14:16:44.771;100;-2148;2248;-1;
2025-08-07 14:16:45.272;101;-2246;2347;-1;
2025-08-07 14:16:45.771;101;-2246;2347;-1;
2025-08-07 14:16:46.272;101;-2296;2397;-1;
2025-08-07 14:16:46.771;101;-2296;2397;-1;
2025-08-07 14:16:47.271;99;-2381;2480;-1;
2025-08-07 14:16:47.775;99;-2381;2480;-1;
2025-08-07 14:16:48.271;99;-2329;2428;-1;
2025-08-07 14:16:48.772;99;-2329;2428;-1;
2025-08-07 14:16:49.271;101;-2348;2449;-1;
2025-08-07 14:16:49.771;101;-2348;2449;-1;
2025-08-07 14:16:50.271;100;-2281;2381;-1;
2025-08-07 14:16:50.772;100;-2281;2381;-1;
2025-08-07 14:16:51.272;100;-2305;2405;-1;
2025-08-07 14:16:51.771;100;-2305;2405;-1;
2025-08-07 14:16:52.271;100;-2333;2433;-1;
2025-08-07 14:16:52.434;9;write_maxlimit_Modbus. Ecriture Modbus de power_limit = 30% (valeur 300 écrite dans le registre 40189)
2025-08-07 14:16:52.600;9;write_maxlimit_Modbus. Fin d'exécution de la procédure
2025-08-07 14:16:52.771;100;-2333;2433;-1;
2025-08-07 14:16:53.272;101;-2337;2438;-1;
2025-08-07 14:16:53.771;101;-2337;2438;-1;
2025-08-07 14:16:54.271;101;-2368;2469;-1;
2025-08-07 14:16:54.771;101;-2368;2469;-1;
2025-08-07 14:16:55.272;104;-2150;2254;-1;
2025-08-07 14:16:55.771;104;-2150;2254;-1;
2025-08-07 14:16:56.271;131;-2119;2250;-1;
2025-08-07 14:16:56.771;131;-2119;2250;-1;
2025-08-07 14:16:57.272;163;-2092;2255;-1;
2025-08-07 14:16:57.771;163;-2092;2255;-1;
2025-08-07 14:16:58.271;210;-2027;2237;-1;
2025-08-07 14:16:58.771;210;-2027;2237;-1;
2025-08-07 14:16:59.271;241;-1999;2240;-1;
2025-08-07 14:16:59.771;241;-1999;2240;-1;
2025-08-07 14:17:00.271;270;-2068;2338;-1;
2025-08-07 14:17:00.771;270;-2068;2338;-1;
2025-08-07 14:17:01.271;286;-2221;2507;-1;
2025-08-07 14:17:01.771;286;-2221;2507;-1;
2025-08-07 14:17:02.271;286;-2154;2440;-1;
2025-08-07 14:17:02.771;286;-2154;2440;-1;
2025-08-07 14:17:03.272;285;-2143;2428;-1;
2025-08-07 14:17:03.771;285;-2143;2428;-1;
2025-08-07 14:17:04.271;287;-2151;2438;-1;
2025-08-07 14:17:04.771;287;-2151;2438;-1;
2025-08-07 14:17:05.271;284;-2147;2431;-1;
2025-08-07 14:17:05.771;284;-2147;2431;-1;
2025-08-07 14:17:06.271;286;-2160;2446;-1;
2025-08-07 14:17:06.770;286;-2160;2446;-1;
2025-08-07 14:17:07.271;286;-2157;2443;-1;
2025-08-07 14:17:07.771;286;-2157;2443;-1;
2025-08-07 14:17:08.271;285;-2173;2458;-1;
2025-08-07 14:17:08.771;285;-2173;2458;-1;
2025-08-07 14:17:09.270;286;-2181;2467;-1;
2025-08-07 14:17:09.771;286;-2181;2467;-1;
2025-08-07 14:17:10.271;284;-1970;2254;-1;
2025-08-07 14:17:10.770;284;-1970;2254;-1;
2025-08-07 14:17:11.271;283;-1969;2252;-1;
2025-08-07 14:17:11.770;283;-1969;2252;-1;
2025-08-07 14:17:12.270;281;-1974;2255;-1;
2025-08-07 14:17:12.771;281;-1974;2255;-1;
2025-08-07 14:17:13.270;282;-1984;2266;-1;
2025-08-07 14:17:13.771;282;-1984;2266;-1;
2025-08-07 14:17:14.270;284;-1970;2254;-1;
2025-08-07 14:17:14.770;284;-1970;2254;-1;
2025-08-07 14:17:15.271;285;-2109;2394;-1;
2025-08-07 14:17:15.770;285;-2109;2394;-1;
2025-08-07 14:17:16.270;282;-2110;2392;-1;
2025-08-07 14:17:16.770;282;-2110;2392;-1;
2025-08-07 14:17:17.270;284;-2195;2479;-1;
2025-08-07 14:17:17.770;284;-2195;2479;-1;
2025-08-07 14:17:18.270;285;-2140;2425;-1;
2025-08-07 14:17:18.770;285;-2140;2425;-1;
2025-08-07 14:17:19.270;283;-2148;2431;-1;
2025-08-07 14:17:19.770;283;-2148;2431;-1;
2025-08-07 14:17:20.270;283;-2165;2448;-1;
2025-08-07 14:17:20.770;283;-2165;2448;-1;
2025-08-07 14:17:21.270;282;-2153;2435;-1;
2025-08-07 14:17:21.770;282;-2153;2435;-1;
2025-08-07 14:17:22.270;287;-2173;2460;-1;
2025-08-07 14:17:22.770;287;-2173;2460;-1;
2025-08-07 14:17:23.270;282;-2222;2504;-1;
2025-08-07 14:17:23.770;282;-2222;2504;-1;
2025-08-07 14:17:24.497;287;-2186;2473;-1;
2025-08-07 14:17:24.770;287;-2186;2473;-1;
2025-08-07 14:17:25.443;284;-1963;2247;-1;
2025-08-07 14:17:25.773;284;-1963;2247;-1;
2025-08-07 14:17:26.270;285;-1967;2252;-1;
2025-08-07 14:17:27.008;285;-1967;2252;-1;
2025-08-07 14:17:27.270;284;-1965;2249;-1;
2025-08-07 14:17:27.882;284;-1965;2249;-1;
2025-08-07 14:17:28.497;285;-1969;2254;-1;
2025-08-07 14:17:28.804;285;-1969;2254;-1;
2025-08-07 14:17:29.270;283;-1968;2251;-1;
2025-08-07 14:17:29.769;283;-1968;2251;-1;
2025-08-07 14:17:30.270;285;-2072;2357;-1;
2025-08-07 14:17:30.769;285;-2072;2357;-1;
2025-08-07 14:17:31.270;287;-2223;2510;-1;
2025-08-07 14:17:31.769;287;-2223;2510;-1;
2025-08-07 14:17:32.270;283;-2137;2420;-1;
2025-08-07 14:17:32.769;283;-2137;2420;-1;
2025-08-07 14:17:33.269;284;-2164;2448;-1;
2025-08-07 14:17:33.770;284;-2164;2448;-1;
2025-08-07 14:17:34.270;286;-2160;2446;-1;
2025-08-07 14:17:34.770;286;-2160;2446;-1;
2025-08-07 14:17:35.269;286;-2138;2424;-1;
2025-08-07 14:17:35.770;286;-2138;2424;-1;
2025-08-07 14:17:36.270;285;-2188;2473;-1;
2025-08-07 14:17:36.770;285;-2188;2473;-1;
2025-08-07 14:17:37.272;285;-2129;2414;-1;
2025-08-07 14:17:37.775;285;-2129;2414;-1;
2025-08-07 14:17:38.269;285;-2155;2440;-1;
2025-08-07 14:17:38.770;285;-2155;2440;-1;
2025-08-07 14:17:39.273;282;-2169;2451;-1;
2025-08-07 14:17:39.770;282;-2169;2451;-1;
2025-08-07 14:17:40.270;288;-1962;2250;-1;
2025-08-07 14:17:40.773;288;-1962;2250;-1;
2025-08-07 14:17:41.269;285;-1965;2250;-1;
2025-08-07 14:17:41.769;285;-1965;2250;-1;
2025-08-07 14:17:42.271;285;-1961;2246;-1;
2025-08-07 14:17:42.769;285;-1961;2246;-1;
2025-08-07 14:17:43.269;284;-1969;2253;-1;
2025-08-07 14:17:43.769;284;-1969;2253;-1;
2025-08-07 14:17:44.269;285;-1973;2258;-1;
2025-08-07 14:17:44.769;285;-1973;2258;-1;
2025-08-07 14:17:45.269;285;-2114;2399;-1;
2025-08-07 14:17:45.769;285;-2114;2399;-1;
2025-08-07 14:17:46.269;290;-2079;2369;-1;
2025-08-07 14:17:46.769;290;-2079;2369;-1;
2025-08-07 14:17:47.269;283;-2216;2499;-1;
2025-08-07 14:17:47.769;283;-2216;2499;-1;
2025-08-07 14:17:48.269;283;-2206;2489;-1;
2025-08-07 14:17:48.769;283;-2206;2489;-1;
2025-08-07 14:17:49.269;290;-2159;2449;-1;
2025-08-07 14:17:49.769;290;-2159;2449;-1;
2025-08-07 14:17:50.269;285;-2180;2465;-1;
2025-08-07 14:17:50.769;285;-2180;2465;-1;
2025-08-07 14:17:51.269;285;-2145;2430;-1;
2025-08-07 14:17:51.342;9;write_maxlimit_Modbus. Ecriture Modbus de power_limit = 50% (valeur 500 écrite dans le registre 40189)
2025-08-07 14:17:51.463;9;write_maxlimit_Modbus. Fin d'exécution de la procédure
2025-08-07 14:17:51.769;285;-2145;2430;-1;
2025-08-07 14:17:52.269;286;-2199;2485;-1;
2025-08-07 14:17:52.769;286;-2199;2485;-1;
2025-08-07 14:17:53.270;289;-2225;2514;-1;
2025-08-07 14:17:53.769;289;-2225;2514;-1;
2025-08-07 14:17:54.269;326;-2113;2439;-1;
2025-08-07 14:17:54.769;326;-2113;2439;-1;
2025-08-07 14:17:55.269;355;-1900;2255;-1;
2025-08-07 14:17:55.769;355;-1900;2255;-1;
2025-08-07 14:17:56.269;393;-1870;2263;-1;
2025-08-07 14:17:56.769;393;-1870;2263;-1;
2025-08-07 14:17:57.269;417;-1842;2259;-1;
2025-08-07 14:17:57.769;417;-1842;2259;-1;
2025-08-07 14:17:58.270;457;-1821;2278;-1;
2025-08-07 14:17:58.769;457;-1821;2278;-1;
2025-08-07 14:17:59.269;473;-1782;2255;-1;
2025-08-07 14:17:59.769;473;-1782;2255;-1;
2025-08-07 14:18:00.269;472;-1890;2362;-1;
2025-08-07 14:18:00.769;472;-1890;2362;-1;
2025-08-07 14:18:01.269;472;-2078;2550;-1;
2025-08-07 14:18:01.769;472;-2078;2550;-1;
2025-08-07 14:18:02.269;474;-1957;2431;-1;
2025-08-07 14:18:02.768;474;-1957;2431;-1;
2025-08-07 14:18:03.508;473;-1963;2436;-1;
2025-08-07 14:18:03.769;473;-1963;2436;-1;
2025-08-07 14:18:04.268;474;-1921;2395;-1;
2025-08-07 14:18:04.769;474;-1921;2395;-1;
2025-08-07 14:18:05.268;476;-1952;2428;-1;
2025-08-07 14:18:05.769;476;-1952;2428;-1;
2025-08-07 14:18:06.268;473;-1984;2457;-1;
2025-08-07 14:18:06.768;473;-1984;2457;-1;
2025-08-07 14:18:07.272;472;-2002;2474;-1;
2025-08-07 14:18:07.769;472;-2002;2474;-1;
2025-08-07 14:18:08.269;467;-1980;2447;-1;
2025-08-07 14:18:08.769;467;-1980;2447;-1;
2025-08-07 14:18:09.268;472;-1996;2468;-1;
2025-08-07 14:18:09.770;472;-1996;2468;-1;
2025-08-07 14:18:10.269;475;-1765;2240;-1;
2025-08-07 14:18:10.768;475;-1765;2240;-1;
2025-08-07 14:18:11.268;475;-1768;2243;-1;
2025-08-07 14:18:11.770;475;-1768;2243;-1;
2025-08-07 14:18:12.268;470;-1776;2246;-1;
2025-08-07 14:18:12.769;470;-1776;2246;-1;
2025-08-07 14:18:13.268;472;-1769;2241;-1;
2025-08-07 14:18:13.768;472;-1769;2241;-1;
2025-08-07 14:18:14.269;472;-1779;2251;-1;
2025-08-07 14:18:14.769;472;-1779;2251;-1;
2025-08-07 14:18:15.269;472;-1896;2368;-1;
2025-08-07 14:18:15.768;472;-1896;2368;-1;
2025-08-07 14:18:16.268;475;-1956;2431;-1;
2025-08-07 14:18:16.768;475;-1956;2431;-1;
2025-08-07 14:18:17.269;475;-1936;2411;-1;
2025-08-07 14:18:17.769;475;-1936;2411;-1;
2025-08-07 14:18:18.268;473;-1995;2468;-1;
2025-08-07 14:18:18.769;473;-1995;2468;-1;
2025-08-07 14:18:19.269;472;-2015;2487;-1;
2025-08-07 14:18:19.768;472;-2015;2487;-1;
2025-08-07 14:18:20.269;471;-1973;2444;-1;
2025-08-07 14:18:20.768;471;-1973;2444;-1;
2025-08-07 14:18:21.268;473;-1972;2445;-1;
2025-08-07 14:18:21.768;473;-1972;2445;-1;
2025-08-07 14:18:22.268;472;-1916;2388;-1;
2025-08-07 14:18:22.768;472;-1916;2388;-1;
2025-08-07 14:18:23.268;474;-1975;2449;-1;
2025-08-07 14:18:23.768;474;-1975;2449;-1;
2025-08-07 14:18:24.268;474;-1991;2465;-1;
2025-08-07 14:18:24.768;474;-1991;2465;-1;
2025-08-07 14:18:25.268;472;-1775;2247;-1;
2025-08-07 14:18:25.768;472;-1775;2247;-1;
2025-08-07 14:18:26.268;470;-1775;2245;-1;
2025-08-07 14:18:26.768;470;-1775;2245;-1;
2025-08-07 14:18:27.268;472;-1772;2244;-1;
2025-08-07 14:18:27.768;472;-1772;2244;-1;
2025-08-07 14:18:28.268;475;-1771;2246;-1;
2025-08-07 14:18:28.767;475;-1771;2246;-1;
2025-08-07 14:18:29.268;473;-1771;2244;-1;
2025-08-07 14:18:29.767;473;-1771;2244;-1;
2025-08-07 14:18:30.268;472;-1882;2354;-1;
2025-08-07 14:18:30.767;472;-1882;2354;-1;
2025-08-07 14:18:31.269;472;-2040;2512;-1;
2025-08-07 14:18:31.767;472;-2040;2512;-1;
2025-08-07 14:18:32.268;472;-1989;2461;-1;
2025-08-07 14:18:32.767;472;-1989;2461;-1;
2025-08-07 14:18:33.268;473;-1924;2397;-1;
2025-08-07 14:18:33.935;473;-1924;2397;-1;
2025-08-07 14:18:34.281;472;-1949;2421;-1;
2025-08-07 14:18:34.767;472;-1949;2421;-1;
2025-08-07 14:18:35.500;473;-1996;2469;-1;
2025-08-07 14:18:35.830;473;-1996;2469;-1;
2025-08-07 14:18:36.274;471;-2026;2497;-1;
2025-08-07 14:18:36.768;471;-2026;2497;-1;
2025-08-07 14:18:37.331;473;-2001;2474;-1;
2025-08-07 14:18:37.768;473;-2001;2474;-1;
2025-08-07 14:18:38.268;470;-2017;2487;-1;
2025-08-07 14:18:38.767;470;-2017;2487;-1;
2025-08-07 14:18:39.268;472;-1979;2451;-1;
2025-08-07 14:18:39.769;472;-1979;2451;-1;
2025-08-07 14:18:40.268;474;-1791;2265;-1;
2025-08-07 14:18:40.767;474;-1791;2265;-1;
2025-08-07 14:18:41.267;472;-1795;2267;-1;
2025-08-07 14:18:41.767;472;-1795;2267;-1;
2025-08-07 14:18:42.267;472;-1792;2264;-1;
2025-08-07 14:18:42.767;472;-1792;2264;-1;
2025-08-07 14:18:43.272;473;-1793;2266;-1;
2025-08-07 14:18:43.767;473;-1793;2266;-1;
2025-08-07 14:18:44.267;473;-1792;2265;-1;
2025-08-07 14:18:44.767;473;-1792;2265;-1;
2025-08-07 14:18:45.267;472;-1914;2386;-1;
2025-08-07 14:18:45.767;472;-1914;2386;-1;
2025-08-07 14:18:46.267;473;-2064;2537;-1;
2025-08-07 14:18:46.767;473;-2064;2537;-1;
2025-08-07 14:18:47.267;472;-1963;2435;-1;
2025-08-07 14:18:47.767;472;-1963;2435;-1;
2025-08-07 14:18:48.267;471;-1995;2466;-1;
2025-08-07 14:18:48.767;471;-1995;2466;-1;
2025-08-07 14:18:49.267;474;-2015;2489;-1;
2025-08-07 14:18:49.769;474;-2015;2489;-1;
2025-08-07 14:18:50.267;475;-1993;2468;-1;
2025-08-07 14:18:50.767;475;-1993;2468;-1;
2025-08-07 14:18:51.267;473;-1981;2454;-1;
2025-08-07 14:18:51.767;473;-1981;2454;-1;
2025-08-07 14:18:52.267;472;-1979;2451;-1;
2025-08-07 14:18:52.767;472;-1979;2451;-1;
2025-08-07 14:18:53.266;475;-1941;2416;-1;
2025-08-07 14:18:53.766;475;-1941;2416;-1;
2025-08-07 14:18:53.813;9;write_maxlimit_Modbus. Ecriture Modbus de power_limit = 30% (valeur 300 écrite dans le registre 40189)
2025-08-07 14:18:54.090;9;write_maxlimit_Modbus. Fin d'exécution de la procédure
2025-08-07 14:18:54.267;473;-2031;2504;-1;
2025-08-07 14:18:54.767;473;-2031;2504;-1;
2025-08-07 14:18:55.267;475;-1787;2262;-1;
2025-08-07 14:18:55.767;475;-1787;2262;-1;
2025-08-07 14:18:56.266;473;-1789;2262;-1;
2025-08-07 14:18:56.767;473;-1789;2262;-1;
2025-08-07 14:18:57.267;475;-1770;2245;-1;
2025-08-07 14:18:57.766;475;-1770;2245;-1;
2025-08-07 14:18:58.266;457;-3797;4254;-1;
2025-08-07 14:18:58.766;457;-3797;4254;-1;
2025-08-07 14:18:59.266;433;-3791;4224;-1;
2025-08-07 14:18:59.766;433;-3791;4224;-1;
2025-08-07 14:19:00.266;411;-3912;4323;-1;
2025-08-07 14:19:00.766;411;-3912;4323;-1;
2025-08-07 14:19:01.266;389;-4025;4414;-1;
2025-08-07 14:19:01.767;389;-4025;4414;-1;
2025-08-07 14:19:02.267;368;-4046;4414;-1;
2025-08-07 14:19:02.766;368;-4046;4414;-1;
2025-08-07 14:19:03.268;289;-4060;4349;-1;
2025-08-07 14:19:03.767;289;-4060;4349;-1;
2025-08-07 14:19:04.266;280;-4155;4435;-1;
2025-08-07 14:19:04.766;280;-4155;4435;-1;
2025-08-07 14:19:05.266;283;-4153;4436;-1;
2025-08-07 14:19:05.766;283;-4153;4436;-1;
2025-08-07 14:19:06.266;289;-4114;4403;-1;
2025-08-07 14:19:06.766;289;-4114;4403;-1;
2025-08-07 14:19:07.266;283;-4142;4425;-1;
2025-08-07 14:19:07.767;283;-4142;4425;-1;
2025-08-07 14:19:08.266;283;-4125;4408;-1;
2025-08-07 14:19:08.766;283;-4125;4408;-1;
2025-08-07 14:19:09.266;285;-4085;4370;-1;
2025-08-07 14:19:09.767;285;-4085;4370;-1;
2025-08-07 14:19:10.266;285;-3939;4224;-1;
2025-08-07 14:19:10.766;285;-3939;4224;-1;
2025-08-07 14:19:11.266;283;-3949;4232;-1;
2025-08-07 14:19:11.766;283;-3949;4232;-1;
2025-08-07 14:19:12.266;285;-3957;4242;-1;
2025-08-07 14:19:12.768;285;-3957;4242;-1;
2025-08-07 14:19:13.266;281;-3948;4229;-1;
2025-08-07 14:19:13.766;281;-3948;4229;-1;
2025-08-07 14:19:14.265;286;-3953;4239;-1;
2025-08-07 14:19:14.766;286;-3953;4239;-1;
2025-08-07 14:19:15.266;285;-4075;4360;-1;
2025-08-07 14:19:15.766;285;-4075;4360;-1;
2025-08-07 14:19:16.266;281;-4193;4474;-1;
2025-08-07 14:19:16.766;281;-4193;4474;-1;
2025-08-07 14:19:17.266;284;-4117;4401;-1;
2025-08-07 14:19:17.766;284;-4117;4401;-1;
2025-08-07 14:19:18.266;283;-4084;4367;-1;
2025-08-07 14:19:18.766;283;-4084;4367;-1;
2025-08-07 14:19:19.266;284;-4133;4417;-1;
2025-08-07 14:19:19.766;284;-4133;4417;-1;
2025-08-07 14:19:20.266;281;-4115;4396;-1;
2025-08-07 14:19:20.766;281;-4115;4396;-1;
2025-08-07 14:19:21.266;286;-4128;4414;-1;
2025-08-07 14:19:21.765;286;-4128;4414;-1;
2025-08-07 14:19:22.266;284;-4115;4399;-1;
2025-08-07 14:19:22.766;284;-4115;4399;-1;
2025-08-07 14:19:23.266;287;-4110;4397;-1;
2025-08-07 14:19:23.766;287;-4110;4397;-1;
2025-08-07 14:19:24.265;285;-4119;4404;-1;
2025-08-07 14:19:24.767;285;-4119;4404;-1;
2025-08-07 14:19:25.265;285;-3949;4234;-1;
2025-08-07 14:19:25.765;285;-3949;4234;-1;
2025-08-07 14:19:26.265;284;-3950;4234;-1;
2025-08-07 14:19:26.765;284;-3950;4234;-1;
2025-08-07 14:19:27.266;284;-3962;4246;-1;
2025-08-07 14:19:27.766;284;-3962;4246;-1;
2025-08-07 14:19:28.265;284;-3968;4252;-1;
2025-08-07 14:19:28.765;284;-3968;4252;-1;
2025-08-07 14:19:29.265;286;-3964;4250;-1;
2025-08-07 14:19:29.766;286;-3964;4250;-1;
2025-08-07 14:19:30.265;286;-4046;4332;-1;
2025-08-07 14:19:30.766;286;-4046;4332;-1;
2025-08-07 14:19:31.265;285;-4129;4414;-1;
2025-08-07 14:19:31.765;285;-4129;4414;-1;
2025-08-07 14:19:32.265;283;-4101;4384;-1;
2025-08-07 14:19:32.766;283;-4101;4384;-1;
2025-08-07 14:19:33.265;285;-4118;4403;-1;
2025-08-07 14:19:33.765;285;-4118;4403;-1;
2025-08-07 14:19:34.265;285;-4178;4463;-1;
2025-08-07 14:19:34.765;285;-4178;4463;-1;
2025-08-07 14:19:35.266;285;-4207;4492;-1;
2025-08-07 14:19:35.765;285;-4207;4492;-1;
2025-08-07 14:19:36.265;286;-4146;4432;-1;
2025-08-07 14:19:36.765;286;-4146;4432;-1;
2025-08-07 14:19:37.265;285;-4163;4448;-1;
2025-08-07 14:19:37.767;285;-4163;4448;-1;
2025-08-07 14:19:38.265;285;-4165;4450;-1;
2025-08-07 14:19:38.765;285;-4165;4450;-1;
2025-08-07 14:19:39.265;287;-4144;4431;-1;
2025-08-07 14:19:39.766;287;-4144;4431;-1;
2025-08-07 14:19:40.266;286;-3984;4270;-1;
2025-08-07 14:19:40.765;286;-3984;4270;-1;
2025-08-07 14:19:41.265;285;-3993;4278;-1;
2025-08-07 14:19:41.765;285;-3993;4278;-1;
2025-08-07 14:19:42.265;286;-3975;4261;-1;
2025-08-07 14:19:42.771;286;-3975;4261;-1;
2025-08-07 14:19:43.265;285;-3978;4263;-1;
2025-08-07 14:19:43.765;285;-3978;4263;-1;
2025-08-07 14:19:44.265;285;-3971;4256;-1;
2025-08-07 14:19:44.765;285;-3971;4256;-1;
2025-08-07 14:19:45.266;285;-4125;4410;-1;
2025-08-07 14:19:45.312;9;write_maxlimit_Modbus. Ecriture Modbus de power_limit = 20% (valeur 200 écrite dans le registre 40189)
2025-08-07 14:19:45.453;9;write_maxlimit_Modbus. Fin d'exécution de la procédure
2025-08-07 14:19:45.766;285;-4125;4410;-1;
2025-08-07 14:19:46.266;285;-4219;4504;-1;
2025-08-07 14:19:46.764;285;-4219;4504;-1;
2025-08-07 14:19:47.265;274;-4113;4387;-1;
2025-08-07 14:19:47.764;274;-4113;4387;-1;
2025-08-07 14:19:48.265;250;-4090;4340;-1;
2025-08-07 14:19:48.765;250;-4090;4340;-1;
2025-08-07 14:19:49.265;229;-4165;4394;-1;
2025-08-07 14:19:49.765;229;-4165;4394;-1;
2025-08-07 14:19:50.264;209;-4222;4431;-1;
2025-08-07 14:19:50.767;209;-4222;4431;-1;
2025-08-07 14:19:51.266;192;-4122;4314;-1;
2025-08-07 14:19:51.765;192;-4122;4314;-1;
2025-08-07 14:19:52.265;190;-4199;4389;-1;
2025-08-07 14:19:52.764;190;-4199;4389;-1;
2025-08-07 14:19:53.264;192;-4162;4354;-1;
2025-08-07 14:19:53.765;192;-4162;4354;-1;
2025-08-07 14:19:54.264;193;-4147;4340;-1;
2025-08-07 14:19:54.764;193;-4147;4340;-1;
2025-08-07 14:19:55.265;193;-4014;4207;-1;
2025-08-07 14:19:55.764;193;-4014;4207;-1;
2025-08-07 14:19:56.264;195;-3999;4194;-1;
2025-08-07 14:19:56.764;195;-3999;4194;-1;
2025-08-07 14:19:57.265;198;-3999;4197;-1;
2025-08-07 14:19:57.769;198;-3999;4197;-1;
2025-08-07 14:19:58.264;195;-4021;4216;-1;
2025-08-07 14:19:58.764;195;-4021;4216;-1;
2025-08-07 14:19:59.264;196;-4009;4205;-1;
2025-08-07 14:19:59.770;196;-4009;4205;-1;
2025-08-07 14:20:00.264;193;-4093;4286;-1;
2025-08-07 14:20:00.764;193;-4093;4286;-1;
2025-08-07 14:20:01.264;196;-4187;4383;-1;
2025-08-07 14:20:01.764;196;-4187;4383;-1;
2025-08-07 14:20:02.264;192;-4112;4304;-1;
2025-08-07 14:20:02.764;192;-4112;4304;-1;
2025-08-07 14:20:03.265;194;-4135;4329;-1;
2025-08-07 14:20:03.764;194;-4135;4329;-1;
2025-08-07 14:20:04.264;193;-4184;4377;-1;
2025-08-07 14:20:04.765;193;-4184;4377;-1;
2025-08-07 14:20:05.264;193;-4190;4383;-1;
2025-08-07 14:20:05.764;193;-4190;4383;-1;
2025-08-07 14:20:06.264;193;-4160;4353;-1;
2025-08-07 14:20:06.764;193;-4160;4353;-1;
2025-08-07 14:20:07.264;194;-4191;4385;-1;
2025-08-07 14:20:07.764;194;-4191;4385;-1;
2025-08-07 14:20:08.264;191;-4163;4354;-1;
2025-08-07 14:20:08.764;191;-4163;4354;-1;
2025-08-07 14:20:09.264;193;-4161;4354;-1;
2025-08-07 14:20:09.764;193;-4161;4354;-1;
2025-08-07 14:20:10.264;192;-3971;4163;-1;
2025-08-07 14:20:10.764;192;-3971;4163;-1;
2025-08-07 14:20:11.264;193;-3968;4161;-1;
2025-08-07 14:20:11.764;193;-3968;4161;-1;
2025-08-07 14:20:12.264;194;-4001;4195;-1;
2025-08-07 14:20:12.764;194;-4001;4195;-1;
2025-08-07 14:20:13.264;194;-4013;4207;-1;
2025-08-07 14:20:13.764;194;-4013;4207;-1;
2025-08-07 14:20:14.264;194;-3980;4174;-1;
2025-08-07 14:20:14.764;194;-3980;4174;-1;
2025-08-07 14:20:15.264;193;-4121;4314;-1;
2025-08-07 14:20:15.764;193;-4121;4314;-1;
2025-08-07 14:20:16.264;193;-4261;4454;-1;
2025-08-07 14:20:16.763;193;-4261;4454;-1;
2025-08-07 14:20:17.264;198;-4201;4399;-1;
2025-08-07 14:20:17.764;198;-4201;4399;-1;
2025-08-07 14:20:18.263;192;-4157;4349;-1;
2025-08-07 14:20:18.764;192;-4157;4349;-1;
2025-08-07 14:20:19.263;198;-4215;4413;-1;
2025-08-07 14:20:19.764;198;-4215;4413;-1;
2025-08-07 14:20:20.263;191;-4259;4450;-1;
2025-08-07 14:20:20.764;191;-4259;4450;-1;
2025-08-07 14:20:21.263;193;-4185;4378;-1;
2025-08-07 14:20:21.763;193;-4185;4378;-1;
2025-08-07 14:20:22.264;198;-4193;4391;-1;
2025-08-07 14:20:22.763;198;-4193;4391;-1;
2025-08-07 14:20:23.264;199;-4169;4368;-1;
2025-08-07 14:20:23.764;199;-4169;4368;-1;
2025-08-07 14:20:24.264;211;-4118;4329;-1;
2025-08-07 14:20:24.831;211;-4118;4329;-1;
2025-08-07 14:20:25.447;216;-3988;4204;-1;
2025-08-07 14:20:25.763;216;-3988;4204;-1;
2025-08-07 14:20:26.365;278;-3924;4202;-1;
2025-08-07 14:20:26.985;278;-3924;4202;-1;
2025-08-07 14:20:27.264;425;-3775;4200;-1;
2025-08-07 14:20:27.902;425;-3775;4200;-1;
2025-08-07 14:20:28.264;463;-3750;4213;-1;
2025-08-07 14:20:28.763;463;-3750;4213;-1;
2025-08-07 14:20:29.263;533;-3685;4218;-1;
2025-08-07 14:20:29.763;533;-3685;4218;-1;
2025-08-07 14:20:30.263;532;-3762;4294;-1;
2025-08-07 14:20:30.764;532;-3762;4294;-1;
2025-08-07 14:20:31.263;534;-3858;4392;-1;
2025-08-07 14:20:31.763;534;-3858;4392;-1;
2025-08-07 14:20:32.263;533;-3785;4318;-1;
2025-08-07 14:20:32.763;533;-3785;4318;-1;
2025-08-07 14:20:33.263;530;-3889;4419;-1;
2025-08-07 14:20:33.763;530;-3889;4419;-1;
2025-08-07 14:20:34.262;534;-3889;4423;-1;
2025-08-07 14:20:34.763;534;-3889;4423;-1;
2025-08-07 14:20:35.263;533;-3842;4375;-1;
2025-08-07 14:20:35.763;533;-3842;4375;-1;
2025-08-07 14:20:36.263;533;-3868;4401;-1;
2025-08-07 14:20:36.763;533;-3868;4401;-1;
2025-08-07 14:20:37.263;534;-3842;4376;-1;
2025-08-07 14:20:37.764;534;-3842;4376;-1;
2025-08-07 14:20:38.263;532;-3839;4371;-1;
2025-08-07 14:20:38.763;532;-3839;4371;-1;
2025-08-07 14:20:39.263;533;-3855;4388;-1;
2025-08-07 14:20:39.763;533;-3855;4388;-1;
2025-08-07 14:20:40.262;533;-1685;2218;-1;
2025-08-07 14:20:40.763;533;-1685;2218;-1;
2025-08-07 14:20:41.263;533;-2917;3450;-1;
2025-08-07 14:20:41.762;533;-2917;3450;-1;
2025-08-07 14:20:42.263;535;-1877;2412;-1;
2025-08-07 14:20:42.764;535;-1877;2412;-1;
2025-08-07 14:20:43.263;530;-1824;2354;-1;
2025-08-07 14:20:43.762;530;-1824;2354;-1;
2025-08-07 14:20:44.262;533;-1825;2358;-1;
2025-08-07 14:20:44.762;533;-1825;2358;-1;
2025-08-07 14:20:45.263;533;-1946;2479;-1;
2025-08-07 14:20:45.762;533;-1946;2479;-1;
2025-08-07 14:20:46.262;534;-2098;2632;-1;
2025-08-07 14:20:46.763;534;-2098;2632;-1;
2025-08-07 14:20:47.262;531;-2030;2561;-1;
2025-08-07 14:20:47.763;531;-2030;2561;-1;
2025-08-07 14:20:48.262;532;-2004;2536;-1;
2025-08-07 14:20:48.762;532;-2004;2536;-1;
2025-08-07 14:20:49.262;533;-1982;2515;-1;
2025-08-07 14:20:49.763;533;-1982;2515;-1;
2025-08-07 14:20:50.263;534;-2060;2594;-1;
2025-08-07 14:20:50.762;534;-2060;2594;-1;
2025-08-07 14:20:51.263;533;-2071;2604;-1;
2025-08-07 14:20:51.762;533;-2071;2604;-1;
2025-08-07 14:20:52.263;533;-2014;2547;-1;
2025-08-07 14:20:52.762;533;-2014;2547;-1;
2025-08-07 14:20:53.262;533;-2013;2546;-1;
2025-08-07 14:20:53.762;533;-2013;2546;-1;
2025-08-07 14:20:54.263;536;-2000;2536;-1;
2025-08-07 14:20:54.762;536;-2000;2536;-1;
2025-08-07 14:20:55.263;534;-1825;2359;-1;
2025-08-07 14:20:55.763;534;-1825;2359;-1;
2025-08-07 14:20:56.262;532;-1823;2355;-1;
2025-08-07 14:20:56.762;532;-1823;2355;-1;
2025-08-07 14:20:57.262;535;-1803;2338;-1;
2025-08-07 14:20:57.762;535;-1803;2338;-1;
2025-08-07 14:20:58.262;534;-1804;2338;-1;
2025-08-07 14:20:58.592;9;write_maxlimit_Modbus. Ecriture Modbus de power_limit = 10% (valeur 100 écrite dans le registre 40189)
2025-08-07 14:20:58.762;534;-1804;2338;-1;
2025-08-07 14:20:58.853;9;write_maxlimit_Modbus. Fin d'exécution de la procédure
2025-08-07 14:20:59.262;531;-1810;2341;-1;
2025-08-07 14:20:59.762;531;-1810;2341;-1;
2025-08-07 14:21:00.263;529;-1934;2463;-1;
2025-08-07 14:21:00.762;529;-1934;2463;-1;
2025-08-07 14:21:01.262;512;-2034;2546;-1;
2025-08-07 14:21:01.762;512;-2034;2546;-1;
2025-08-07 14:21:02.262;466;-1992;2458;-1;
2025-08-07 14:21:02.762;466;-1992;2458;-1;
2025-08-07 14:21:03.744;384;-2133;2517;-1;
2025-08-07 14:21:04.262;330;-2247;2577;-1;
2025-08-07 14:21:04.762;330;-2247;2577;-1;
2025-08-07 14:21:05.262;295;-2247;2542;-1;
2025-08-07 14:21:05.762;295;-2247;2542;-1;
2025-08-07 14:21:06.262;283;-2270;2553;-1;
2025-08-07 14:21:06.762;283;-2270;2553;-1;
2025-08-07 14:21:07.262;274;-2265;2539;-1;
2025-08-07 14:21:07.762;274;-2265;2539;-1;
2025-08-07 14:21:08.261;265;-2253;2518;-1;
2025-08-07 14:21:08.762;265;-2253;2518;-1;
2025-08-07 14:21:09.262;263;-2286;2549;-1;
2025-08-07 14:21:09.762;263;-2286;2549;-1;
2025-08-07 14:21:10.264;265;-2086;2351;-1;
2025-08-07 14:21:10.762;265;-2086;2351;-1;
2025-08-07 14:21:11.262;265;-2084;2349;-1;
2025-08-07 14:21:11.762;265;-2084;2349;-1;
2025-08-07 14:21:12.263;266;-2093;2359;-1;
2025-08-07 14:21:12.761;266;-2093;2359;-1;
2025-08-07 14:21:13.263;265;-2093;2358;-1;
2025-08-07 14:21:13.762;265;-2093;2358;-1;
2025-08-07 14:21:14.261;266;-2082;2348;-1;
2025-08-07 14:21:14.761;266;-2082;2348;-1;
2025-08-07 14:21:15.262;266;-2206;2472;-1;
2025-08-07 14:21:15.762;266;-2206;2472;-1;
2025-08-07 14:21:16.261;265;-2372;2637;-1;
2025-08-07 14:21:16.761;265;-2372;2637;-1;
2025-08-07 14:21:17.261;265;-2355;2620;-1;
2025-08-07 14:21:17.762;265;-2355;2620;-1;
2025-08-07 14:21:18.261;264;-2300;2564;-1;
2025-08-07 14:21:18.762;264;-2300;2564;-1;
2025-08-07 14:21:19.261;266;-2280;2546;-1;
2025-08-07 14:21:19.762;266;-2280;2546;-1;
2025-08-07 14:21:20.261;266;-2348;2614;-1;
2025-08-07 14:21:20.761;266;-2348;2614;-1;
2025-08-07 14:21:21.262;266;-2304;2570;-1;
2025-08-07 14:21:21.761;266;-2304;2570;-1;
2025-08-07 14:21:22.262;265;-2323;2588;-1;
2025-08-07 14:21:22.761;265;-2323;2588;-1;
2025-08-07 14:21:23.261;264;-2309;2573;-1;
2025-08-07 14:21:23.761;264;-2309;2573;-1;
2025-08-07 14:21:24.261;265;-2246;2511;-1;
2025-08-07 14:21:24.761;265;-2246;2511;-1;
2025-08-07 14:21:25.261;265;-2140;2405;-1;
2025-08-07 14:21:25.761;265;-2140;2405;-1;
2025-08-07 14:21:26.267;267;-2096;2363;-1;
2025-08-07 14:21:26.761;267;-2096;2363;-1;
2025-08-07 14:21:27.266;265;-2094;2359;-1;
2025-08-07 14:21:27.761;265;-2094;2359;-1;
2025-08-07 14:21:28.266;265;-2091;2356;-1;
2025-08-07 14:21:28.761;265;-2091;2356;-1;
2025-08-07 14:21:29.261;265;-2097;2362;-1;
2025-08-07 14:21:29.760;265;-2097;2362;-1;
2025-08-07 14:21:30.266;265;-2195;2460;-1;
2025-08-07 14:21:30.761;265;-2195;2460;-1;
2025-08-07 14:21:31.264;264;-2298;2562;-1;
2025-08-07 14:21:31.762;264;-2298;2562;-1;
2025-08-07 14:21:32.260;265;-2302;2567;-1;
2025-08-07 14:21:32.762;265;-2302;2567;-1;
2025-08-07 14:21:33.263;261;-2306;2567;-1;
2025-08-07 14:21:33.761;261;-2306;2567;-1;
2025-08-07 14:21:34.262;267;-2355;2622;-1;
2025-08-07 14:21:34.761;267;-2355;2622;-1;
2025-08-07 14:21:35.260;265;-2270;2535;-1;
2025-08-07 14:21:35.761;265;-2270;2535;-1;
2025-08-07 14:21:36.261;263;-2274;2537;-1;
2025-08-07 14:21:36.761;263;-2274;2537;-1;
2025-08-07 14:21:37.284;264;-2283;2547;-1;
2025-08-07 14:21:37.761;264;-2283;2547;-1;
2025-08-07 14:21:38.260;263;-2253;2516;-1;
2025-08-07 14:21:38.761;263;-2253;2516;-1;
2025-08-07 14:21:39.260;265;-2343;2608;-1;
2025-08-07 14:21:39.760;265;-2343;2608;-1;
2025-08-07 14:21:40.262;267;-2095;2362;-1;
2025-08-07 14:21:40.760;267;-2095;2362;-1;
2025-08-07 14:21:41.260;264;-2100;2364;-1;
2025-08-07 14:21:41.760;264;-2100;2364;-1;
2025-08-07 14:21:42.260;266;-2092;2358;-1;
2025-08-07 14:21:42.761;266;-2092;2358;-1;
2025-08-07 14:21:43.270;265;-2100;2365;-1;
2025-08-07 14:21:43.760;265;-2100;2365;-1;
2025-08-07 14:21:44.260;263;-2093;2356;-1;
2025-08-07 14:21:44.760;263;-2093;2356;-1;
2025-08-07 14:21:45.260;263;-2222;2485;-1;
2025-08-07 14:21:45.760;263;-2222;2485;-1;
2025-08-07 14:21:46.260;266;-2383;2649;-1;
2025-08-07 14:21:46.760;266;-2383;2649;-1;
2025-08-07 14:21:47.260;263;-2268;2531;-1;
2025-08-07 14:21:47.760;263;-2268;2531;-1;
2025-08-07 14:21:48.260;265;-2304;2569;-1;
2025-08-07 14:21:48.761;265;-2304;2569;-1;
2025-08-07 14:21:49.260;266;-2272;2538;-1;
2025-08-07 14:21:49.760;266;-2272;2538;-1;
2025-08-07 14:21:50.260;265;-2343;2608;-1;
2025-08-07 14:21:50.760;265;-2343;2608;-1;
2025-08-07 14:21:51.260;264;-2347;2611;-1;
2025-08-07 14:21:51.760;264;-2347;2611;-1;
2025-08-07 14:21:52.260;265;-2301;2566;-1;
2025-08-07 14:21:52.760;265;-2301;2566;-1;
2025-08-07 14:21:53.260;265;-2297;2562;-1;
2025-08-07 14:21:53.760;265;-2297;2562;-1;
2025-08-07 14:21:54.260;266;-2267;2533;-1;
2025-08-07 14:21:54.760;266;-2267;2533;-1;
2025-08-07 14:21:55.260;268;-2104;2372;-1;
2025-08-07 14:21:55.760;268;-2104;2372;-1;
2025-08-07 14:21:56.259;263;-2108;2371;-1;
2025-08-07 14:21:56.759;263;-2108;2371;-1;
2025-08-07 14:21:57.261;266;-2100;2366;-1;
2025-08-07 14:21:57.760;266;-2100;2366;-1;
2025-08-07 14:21:58.259;267;-78;345;-1;
2025-08-07 14:21:58.760;267;-78;345;-1;
2025-08-07 14:21:59.260;266;-81;347;-1;
2025-08-07 14:21:59.759;266;-81;347;-1;
2025-08-07 14:22:00.259;266;-87;353;-1;
2025-08-07 14:22:00.759;266;-87;353;-1;
2025-08-07 14:22:01.259;265;-79;344;-1;
2025-08-07 14:22:01.759;265;-79;344;-1;
2025-08-07 14:22:02.259;266;-80;346;-1;
2025-08-07 14:22:02.760;266;-80;346;-1;
2025-08-07 14:22:03.290;267;-85;352;-1;
2025-08-07 14:22:03.767;267;-85;352;-1;
2025-08-07 14:22:04.273;268;-153;421;-1;
2025-08-07 14:22:04.407;9;write_maxlimit_Modbus. Ecriture Modbus de power_limit = 20% (valeur 200 écrite dans le registre 40189)
2025-08-07 14:22:04.556;9;write_maxlimit_Modbus. Fin d'exécution de la procédure
2025-08-07 14:22:04.759;268;-153;421;-1;
2025-08-07 14:22:05.263;267;-293;560;-1;
2025-08-07 14:22:05.759;267;-293;560;-1;
2025-08-07 14:22:06.259;267;-242;509;-1;
2025-08-07 14:22:06.759;267;-242;509;-1;
2025-08-07 14:22:07.260;267;-333;600;-1;
2025-08-07 14:22:07.759;267;-333;600;-1;
2025-08-07 14:22:08.259;267;-281;548;-1;
2025-08-07 14:22:08.759;267;-281;548;-1;
2025-08-07 14:22:09.260;267;-278;545;-1;
2025-08-07 14:22:09.759;267;-278;545;-1;
2025-08-07 14:22:10.260;271;-308;579;-1;
2025-08-07 14:22:10.759;271;-308;579;-1;
2025-08-07 14:22:11.259;324;-183;507;-1;
2025-08-07 14:22:11.759;324;-183;507;-1;
2025-08-07 14:22:12.259;394;-188;582;-1;
2025-08-07 14:22:12.759;394;-188;582;-1;
2025-08-07 14:22:13.260;478;-93;571;-1;
2025-08-07 14:22:13.759;478;-93;571;-1;
2025-08-07 14:22:14.259;520;-20;540;-1;
2025-08-07 14:22:14.759;520;-20;540;-1;
2025-08-07 14:22:15.259;526;-42;568;-1;
2025-08-07 14:22:15.759;526;-42;568;-1;
2025-08-07 14:22:16.259;526;4;522;-1;
2025-08-07 14:22:16.759;526;4;522;-1;
2025-08-07 14:22:17.259;527;-35;562;-1;
2025-08-07 14:22:17.759;527;-35;562;-1;
2025-08-07 14:22:18.259;531;-84;615;-1;
2025-08-07 14:22:18.759;531;-84;615;-1;
2025-08-07 14:22:19.266;528;-15;543;-1;
2025-08-07 14:22:19.759;528;-15;543;-1;
2025-08-07 14:22:20.259;526;-31;557;-1;
2025-08-07 14:22:20.759;526;-31;557;-1;
2025-08-07 14:22:21.260;530;18;512;-1;
2025-08-07 14:22:21.759;530;18;512;-1;
2025-08-07 14:22:22.261;528;0;528;-1;
2025-08-07 14:22:22.759;528;0;528;-1;
2025-08-07 14:22:23.259;527;-52;579;-1;
2025-08-07 14:22:23.759;527;-52;579;-1;
2025-08-07 14:22:24.259;528;-6;534;-1;
2025-08-07 14:22:24.759;528;-6;534;-1;
2025-08-07 14:22:25.259;528;-15;543;-1;
2025-08-07 14:22:25.759;528;-15;543;-1;
2025-08-07 14:22:26.259;527;2;525;-1;
2025-08-07 14:22:26.759;527;2;525;-1;
2025-08-07 14:22:27.259;526;21;505;-1;
2025-08-07 14:22:27.760;526;21;505;-1;
2025-08-07 14:22:28.259;526;2;524;-1;
2025-08-07 14:22:28.758;526;2;524;-1;
2025-08-07 14:22:29.259;525;-34;559;-1;
2025-08-07 14:22:29.759;525;-34;559;-1;
2025-08-07 14:22:30.259;525;-3;528;-1;
2025-08-07 14:22:30.758;525;-3;528;-1;
2025-08-07 14:22:31.259;526;4;522;-1;
2025-08-07 14:22:31.758;526;4;522;-1;
2025-08-07 14:22:32.259;526;22;504;-1;
2025-08-07 14:22:32.764;526;22;504;-1;
2025-08-07 14:22:33.259;526;-26;552;-1;
2025-08-07 14:22:33.758;526;-26;552;-1;
2025-08-07 14:22:34.261;528;201;327;-1;
2025-08-07 14:22:34.762;528;201;327;-1;
2025-08-07 14:22:35.259;526;200;326;-1;
2025-08-07 14:22:35.758;526;200;326;-1;
2025-08-07 14:22:36.259;525;198;327;-1;
2025-08-07 14:22:36.759;525;198;327;-1;
2025-08-07 14:22:37.258;527;200;327;-1;
2025-08-07 14:22:37.759;527;200;327;-1;
2025-08-07 14:22:38.258;526;198;328;-1;
2025-08-07 14:22:38.758;526;198;328;-1;
2025-08-07 14:22:39.259;527;131;396;-1;
2025-08-07 14:22:39.759;527;131;396;-1;
2025-08-07 14:22:40.259;532;42;490;-1;
2025-08-07 14:22:40.758;532;42;490;-1;
2025-08-07 14:22:41.258;525;-37;562;-1;
2025-08-07 14:22:41.758;525;-37;562;-1;
2025-08-07 14:22:42.259;534;-52;586;-1;
2025-08-07 14:22:42.758;534;-52;586;-1;
2025-08-07 14:22:43.260;526;3;523;-1;
2025-08-07 14:22:43.787;526;3;523;-1;
2025-08-07 14:22:44.258;526;0;526;-1;
2025-08-07 14:22:44.758;526;0;526;-1;
2025-08-07 14:22:45.258;527;71;456;-1;
2025-08-07 14:22:45.761;527;71;456;-1;
2025-08-07 14:22:46.258;524;13;511;-1;
2025-08-07 14:22:46.758;524;13;511;-1;
2025-08-07 14:22:47.258;529;-33;562;-1;
2025-08-07 14:22:47.758;529;-33;562;-1;
2025-08-07 14:22:48.258;524;-39;563;-1;
2025-08-07 14:22:48.758;524;-39;563;-1;
2025-08-07 14:22:49.258;529;-18;547;-1;
2025-08-07 14:22:49.758;529;-18;547;-1;
2025-08-07 14:22:50.258;525;-25;550;-1;
2025-08-07 14:22:50.758;525;-25;550;-1;
2025-08-07 14:22:51.258;527;28;499;-1;
2025-08-07 14:22:51.758;527;28;499;-1;
2025-08-07 14:22:52.258;527;-39;566;-1;
2025-08-07 14:22:52.758;527;-39;566;-1;
2025-08-07 14:22:53.258;526;-55;581;-1;
2025-08-07 14:22:53.827;526;-55;581;-1;
2025-08-07 14:22:54.479;529;24;505;-1;
2025-08-07 14:22:54.758;529;24;505;-1;
2025-08-07 14:22:55.359;531;-20;551;-1;
2025-08-07 14:22:55.758;531;-20;551;-1;
2025-08-07 14:22:56.285;529;26;503;-1;
2025-08-07 14:22:56.783;529;26;503;-1;
2025-08-07 14:22:57.258;526;18;508;-1;
2025-08-07 14:22:57.757;526;18;508;-1;
2025-08-07 14:22:58.258;529;-49;578;-1;
2025-08-07 14:22:58.758;529;-49;578;-1;
2025-08-07 14:22:59.258;527;19;508;-1;
2025-08-07 14:22:59.758;527;19;508;-1;
2025-08-07 14:23:00.257;529;18;511;-1;
2025-08-07 14:23:00.757;529;18;511;-1;
2025-08-07 14:23:01.258;528;58;470;-1;
2025-08-07 14:23:01.757;528;58;470;-1;
2025-08-07 14:23:02.259;526;17;509;-1;
2025-08-07 14:23:02.757;526;17;509;-1;
2025-08-07 14:23:03.305;527;-46;573;-1;
2025-08-07 14:23:03.758;527;-46;573;-1;
2025-08-07 14:23:04.258;527;-21;548;-1;
2025-08-07 14:23:04.758;527;-21;548;-1;
2025-08-07 14:23:05.258;528;19;509;-1;
2025-08-07 14:23:05.758;528;19;509;-1;
2025-08-07 14:23:06.257;528;-12;540;-1;
2025-08-07 14:23:06.758;528;-12;540;-1;
2025-08-07 14:23:07.257;527;34;493;-1;
2025-08-07 14:23:07.757;527;34;493;-1;
2025-08-07 14:23:08.257;532;-34;566;-1;
2025-08-07 14:23:08.565;9;write_maxlimit_Modbus. Ecriture Modbus de power_limit = 30% (valeur 300 écrite dans le registre 40189)
2025-08-07 14:23:08.718;9;write_maxlimit_Modbus. Fin d'exécution de la procédure
2025-08-07 14:23:08.771;532;-34;566;-1;
2025-08-07 14:23:09.257;527;193;334;-1;
2025-08-07 14:23:09.757;527;193;334;-1;
2025-08-07 14:23:10.257;529;187;342;-1;
2025-08-07 14:23:10.757;529;187;342;-1;
2025-08-07 14:23:11.257;545;210;335;-1;
2025-08-07 14:23:11.757;545;210;335;-1;
2025-08-07 14:23:12.257;662;331;331;-1;
2025-08-07 14:23:12.757;662;331;331;-1;
2025-08-07 14:23:13.281;687;348;339;-1;
2025-08-07 14:23:13.757;687;348;339;-1;
2025-08-07 14:23:14.257;787;403;384;-1;
2025-08-07 14:23:14.757;787;403;384;-1;
2025-08-07 14:23:15.257;781;255;526;-1;
2025-08-07 14:23:15.757;781;255;526;-1;
2025-08-07 14:23:16.257;798;264;534;-1;
2025-08-07 14:23:16.757;798;264;534;-1;
2025-08-07 14:23:17.257;799;261;538;-1;
2025-08-07 14:23:17.757;799;261;538;-1;
2025-08-07 14:23:18.257;797;318;479;-1;
2025-08-07 14:23:18.757;797;318;479;-1;
2025-08-07 14:23:19.257;799;310;489;-1;
2025-08-07 14:23:19.757;799;310;489;-1;
2025-08-07 14:23:20.257;796;328;468;-1;
2025-08-07 14:23:20.757;796;328;468;-1;
2025-08-07 14:23:21.257;796;317;479;-1;
2025-08-07 14:23:21.757;796;317;479;-1;
2025-08-07 14:23:22.257;800;266;534;-1;
2025-08-07 14:23:22.757;800;266;534;-1;
2025-08-07 14:23:23.257;796;299;497;-1;
2025-08-07 14:23:23.756;796;299;497;-1;
2025-08-07 14:23:24.257;796;281;515;-1;
2025-08-07 14:23:24.756;796;281;515;-1;
2025-08-07 14:23:25.256;796;283;513;-1;
2025-08-07 14:23:25.756;796;283;513;-1;
2025-08-07 14:23:26.257;797;324;473;-1;
2025-08-07 14:23:26.757;797;324;473;-1;
2025-08-07 14:23:27.257;798;276;522;-1;
2025-08-07 14:23:27.757;798;276;522;-1;
2025-08-07 14:23:28.257;798;249;549;-1;
2025-08-07 14:23:28.757;798;249;549;-1;
2025-08-07 14:23:29.256;800;298;502;-1;
2025-08-07 14:23:29.757;800;298;502;-1;
2025-08-07 14:23:30.256;801;292;509;-1;
2025-08-07 14:23:30.756;801;292;509;-1;
2025-08-07 14:23:31.256;801;302;499;-1;
2025-08-07 14:23:31.756;801;302;499;-1;
2025-08-07 14:23:32.257;801;270;531;-1;
2025-08-07 14:23:32.756;801;270;531;-1;
2025-08-07 14:23:33.256;800;235;565;-1;
2025-08-07 14:23:33.756;800;235;565;-1;
2025-08-07 14:23:34.256;800;288;512;-1;
2025-08-07 14:23:34.757;800;288;512;-1;
2025-08-07 14:23:35.256;801;277;524;-1;
2025-08-07 14:23:35.756;801;277;524;-1;
2025-08-07 14:23:36.256;801;288;513;-1;
2025-08-07 14:23:36.756;801;288;513;-1;
2025-08-07 14:23:37.257;802;304;498;-1;
2025-08-07 14:23:37.756;802;304;498;-1;
2025-08-07 14:23:38.256;801;240;561;-1;
2025-08-07 14:23:38.757;801;240;561;-1;
2025-08-07 14:23:39.256;795;282;513;-1;
2025-08-07 14:23:39.757;795;282;513;-1;
2025-08-07 14:23:40.256;800;297;503;-1;
2025-08-07 14:23:40.757;800;297;503;-1;
2025-08-07 14:23:41.256;801;295;506;-1;
2025-08-07 14:23:41.756;801;295;506;-1;
2025-08-07 14:23:42.256;801;296;505;-1;
2025-08-07 14:23:42.756;801;296;505;-1;
2025-08-07 14:23:43.257;802;286;516;-1;
2025-08-07 14:23:43.757;802;286;516;-1;
2025-08-07 14:23:44.256;801;491;310;-1;
2025-08-07 14:23:44.756;801;491;310;-1;
2025-08-07 14:23:45.256;799;486;313;-1;
2025-08-07 14:23:45.756;799;486;313;-1;
2025-08-07 14:23:46.256;800;488;312;-1;
2025-08-07 14:23:46.756;800;488;312;-1;
2025-08-07 14:23:47.256;801;491;310;-1;
2025-08-07 14:23:47.756;801;491;310;-1;
2025-08-07 14:23:48.256;800;490;310;-1;
2025-08-07 14:23:48.756;800;490;310;-1;
2025-08-07 14:23:49.256;798;418;380;-1;
2025-08-07 14:23:49.756;798;418;380;-1;
2025-08-07 14:23:50.256;799;278;521;-1;
2025-08-07 14:23:50.756;799;278;521;-1;
2025-08-07 14:23:51.256;801;297;504;-1;
2025-08-07 14:23:51.756;801;297;504;-1;
2025-08-07 14:23:52.256;798;214;584;-1;
2025-08-07 14:23:52.755;798;214;584;-1;
2025-08-07 14:23:53.255;801;272;529;-1;
2025-08-07 14:23:53.756;801;272;529;-1;
2025-08-07 14:23:54.256;799;282;517;-1;
2025-08-07 14:23:54.755;799;282;517;-1;
2025-08-07 14:23:55.255;798;253;545;-1;
2025-08-07 14:23:55.755;798;253;545;-1;
2025-08-07 14:23:56.256;798;319;479;-1;
2025-08-07 14:23:56.755;798;319;479;-1;
2025-08-07 14:23:57.256;800;244;556;-1;
2025-08-07 14:23:57.756;800;244;556;-1;
2025-08-07 14:23:58.255;800;259;541;-1;
2025-08-07 14:23:58.755;800;259;541;-1;
2025-08-07 14:23:59.255;800;287;513;-1;
2025-08-07 14:23:59.755;800;287;513;-1;
2025-08-07 14:24:00.256;801;260;541;-1;
2025-08-07 14:24:00.755;801;260;541;-1;
2025-08-07 14:24:01.255;800;318;482;-1;
2025-08-07 14:24:01.772;800;318;482;-1;
2025-08-07 14:24:02.339;802;269;533;-1;
2025-08-07 14:24:02.988;802;269;533;-1;
2025-08-07 14:24:03.297;800;212;588;-1;
2025-08-07 14:24:03.868;800;212;588;-1;
