time;solar;injection;conso;power_limit;delay
2025-08-07 16:40:39.715;1543;-133;1676;-1;
2025-08-07 16:40:40.214;1543;-133;1676;-1;
2025-08-07 16:40:40.714;1542;-127;1669;-1;
2025-08-07 16:40:41.214;1542;-127;1669;-1;
2025-08-07 16:40:41.714;1544;-118;1662;-1;
2025-08-07 16:40:42.214;1544;-118;1662;-1;
2025-08-07 16:40:42.714;1544;-116;1660;-1;
2025-08-07 16:40:43.214;1544;-116;1660;-1;
2025-08-07 16:40:43.714;1542;-120;1662;-1;
2025-08-07 16:40:44.214;1542;-120;1662;-1;
2025-08-07 16:40:44.714;1543;-118;1661;-1;
2025-08-07 16:40:45.214;1543;-118;1661;-1;
2025-08-07 16:40:45.714;1542;-124;1666;-1;
2025-08-07 16:40:46.213;1542;-124;1666;-1;
2025-08-07 16:40:46.714;1541;-117;1658;-1;
2025-08-07 16:40:47.214;1541;-117;1658;-1;
2025-08-07 16:40:47.714;1540;-128;1668;-1;
2025-08-07 16:40:48.215;1540;-128;1668;-1;
2025-08-07 16:40:48.736;1543;-121;1664;-1;
2025-08-07 16:40:49.214;1543;-121;1664;-1;
2025-08-07 16:40:49.714;1543;-122;1665;-1;
2025-08-07 16:40:50.214;1543;-122;1665;-1;
2025-08-07 16:40:50.714;1544;-111;1655;-1;
2025-08-07 16:40:51.214;1544;-111;1655;-1;
2025-08-07 16:40:51.714;1542;-112;1654;-1;
2025-08-07 16:40:52.214;1542;-112;1654;-1;
2025-08-07 16:40:52.713;1543;-114;1657;-1;
2025-08-07 16:40:53.216;1543;-114;1657;-1;
2025-08-07 16:40:53.714;1537;-123;1660;-1;
2025-08-07 16:40:54.216;1537;-123;1660;-1;
2025-08-07 16:40:54.714;1541;-130;1671;-1;
2025-08-07 16:40:55.213;1541;-130;1671;-1;
2025-08-07 16:40:55.714;1542;-116;1658;-1;
2025-08-07 16:40:56.213;1542;-116;1658;-1;
2025-08-07 16:40:56.713;1542;-116;1658;-1;
2025-08-07 16:40:57.213;1542;-116;1658;-1;
2025-08-07 16:40:57.517;9;write_maxlimit_Modbus. Ecriture Modbus de power_limit = 20% (valeur 200 écrite dans le registre 40189)
2025-08-07 16:40:57.673;9;write_maxlimit_Modbus. Fin d'exécution de la procédure
2025-08-07 16:40:57.724;1542;-137;1679;-1;
2025-08-07 16:40:58.214;1542;-137;1679;-1;
2025-08-07 16:40:58.713;1543;-115;1658;-1;
2025-08-07 16:40:59.213;1543;-115;1658;-1;
2025-08-07 16:40:59.713;1544;-114;1658;-1;
2025-08-07 16:41:00.213;1544;-114;1658;-1;
2025-08-07 16:41:00.801;1544;-109;1653;-1;
2025-08-07 16:41:01.213;1544;-109;1653;-1;
2025-08-07 16:41:01.718;1540;-98;1638;-1;
2025-08-07 16:41:02.213;1540;-98;1638;-1;
2025-08-07 16:41:02.713;1541;-97;1638;-1;
2025-08-07 16:41:03.213;1541;-97;1638;-1;
2025-08-07 16:41:03.713;1527;-110;1637;-1;
2025-08-07 16:41:04.213;1527;-110;1637;-1;
2025-08-07 16:41:04.713;1483;-152;1635;-1;
2025-08-07 16:41:05.213;1483;-152;1635;-1;
2025-08-07 16:41:05.713;1433;-207;1640;-1;
2025-08-07 16:41:06.213;1433;-207;1640;-1;
2025-08-07 16:41:06.714;1370;-275;1645;-1;
2025-08-07 16:41:07.213;1370;-275;1645;-1;
2025-08-07 16:41:07.714;1298;-337;1635;-1;
2025-08-07 16:41:08.213;1298;-337;1635;-1;
2025-08-07 16:41:08.714;1224;-406;1630;-1;
2025-08-07 16:41:09.213;1224;-406;1630;-1;
2025-08-07 16:41:09.714;1150;-481;1631;-1;
2025-08-07 16:41:10.213;1150;-481;1631;-1;
2025-08-07 16:41:10.715;1080;-549;1629;-1;
2025-08-07 16:41:11.213;1080;-549;1629;-1;
2025-08-07 16:41:11.714;1014;-618;1632;-1;
2025-08-07 16:41:12.214;1014;-618;1632;-1;
2025-08-07 16:41:12.714;951;-687;1638;-1;
2025-08-07 16:41:13.213;951;-687;1638;-1;
2025-08-07 16:41:13.714;657;-978;1635;-1;
2025-08-07 16:41:14.213;657;-978;1635;-1;
2025-08-07 16:41:14.712;632;-997;1629;-1;
2025-08-07 16:41:15.213;632;-997;1629;-1;
2025-08-07 16:41:15.714;609;-1024;1633;-1;
2025-08-07 16:41:16.213;609;-1024;1633;-1;
2025-08-07 16:41:16.712;586;-1023;1609;-1;
2025-08-07 16:41:17.213;586;-1023;1609;-1;
2025-08-07 16:41:17.714;564;-1063;1627;-1;
2025-08-07 16:41:18.230;564;-1063;1627;-1;
2025-08-07 16:41:18.713;543;-1080;1623;-1;
2025-08-07 16:41:19.212;543;-1080;1623;-1;
2025-08-07 16:41:19.713;465;-1160;1625;-1;
2025-08-07 16:41:20.213;465;-1160;1625;-1;
2025-08-07 16:41:20.713;438;-1182;1620;-1;
2025-08-07 16:41:21.216;438;-1182;1620;-1;
2025-08-07 16:41:21.714;414;-1211;1625;-1;
2025-08-07 16:41:22.212;414;-1211;1625;-1;
2025-08-07 16:41:22.714;393;-1231;1624;-1;
2025-08-07 16:41:23.218;393;-1231;1624;-1;
2025-08-07 16:41:23.713;374;-1253;1627;-1;
2025-08-07 16:41:24.218;374;-1253;1627;-1;
2025-08-07 16:41:24.713;367;-1263;1630;-1;
2025-08-07 16:41:25.213;367;-1263;1630;-1;
2025-08-07 16:41:25.712;363;-1271;1634;-1;
2025-08-07 16:41:26.212;363;-1271;1634;-1;
2025-08-07 16:41:26.712;369;-1260;1629;-1;
2025-08-07 16:41:27.212;369;-1260;1629;-1;
2025-08-07 16:41:27.714;366;-1266;1632;-1;
2025-08-07 16:41:28.212;366;-1266;1632;-1;
2025-08-07 16:41:28.712;366;-1274;1640;-1;
2025-08-07 16:41:29.213;366;-1274;1640;-1;
2025-08-07 16:41:29.713;368;-1267;1635;-1;
2025-08-07 16:41:30.212;368;-1267;1635;-1;
2025-08-07 16:41:30.713;368;-83;451;-1;
2025-08-07 16:41:31.212;368;-83;451;-1;
2025-08-07 16:41:31.713;371;108;263;-1;
2025-08-07 16:41:32.212;371;108;263;-1;
2025-08-07 16:41:32.712;371;110;261;-1;
2025-08-07 16:41:33.213;371;110;261;-1;
2025-08-07 16:41:33.712;369;108;261;-1;
2025-08-07 16:41:34.212;369;108;261;-1;
2025-08-07 16:41:34.713;372;101;271;-1;
2025-08-07 16:41:35.212;372;101;271;-1;
2025-08-07 16:41:35.713;367;106;261;-1;
2025-08-07 16:41:36.212;367;106;261;-1;
2025-08-07 16:41:36.712;368;107;261;-1;
2025-08-07 16:41:37.212;368;107;261;-1;
2025-08-07 16:41:37.712;373;110;263;-1;
2025-08-07 16:41:38.212;373;110;263;-1;
2025-08-07 16:41:38.712;370;108;262;-1;
2025-08-07 16:41:39.212;370;108;262;-1;
2025-08-07 16:41:39.712;372;111;261;-1;
2025-08-07 16:41:40.212;372;111;261;-1;
2025-08-07 16:41:40.711;368;107;261;-1;
2025-08-07 16:41:41.212;368;107;261;-1;
2025-08-07 16:41:41.712;369;108;261;-1;
2025-08-07 16:41:42.212;369;108;261;-1;
2025-08-07 16:41:42.712;371;113;258;-1;
2025-08-07 16:41:43.212;371;113;258;-1;
2025-08-07 16:41:43.712;368;109;259;-1;
2025-08-07 16:41:44.212;368;109;259;-1;
2025-08-07 16:41:44.713;366;107;259;-1;
2025-08-07 16:41:45.211;366;107;259;-1;
2025-08-07 16:41:45.712;369;108;261;-1;
2025-08-07 16:41:46.212;369;108;261;-1;
2025-08-07 16:41:46.711;370;108;262;-1;
2025-08-07 16:41:47.212;370;108;262;-1;
2025-08-07 16:41:47.711;370;110;260;-1;
2025-08-07 16:41:48.215;370;110;260;-1;
2025-08-07 16:41:48.712;369;107;262;-1;
2025-08-07 16:41:49.211;369;107;262;-1;
2025-08-07 16:41:49.712;368;107;261;-1;
2025-08-07 16:41:50.211;368;107;261;-1;
2025-08-07 16:41:50.711;366;106;260;-1;
2025-08-07 16:41:51.211;366;106;260;-1;
2025-08-07 16:41:51.712;367;107;260;-1;
2025-08-07 16:41:52.211;367;107;260;-1;
2025-08-07 16:41:52.725;367;108;259;-1;
2025-08-07 16:41:53.214;367;108;259;-1;
2025-08-07 16:41:53.712;367;92;275;-1;
2025-08-07 16:41:54.214;367;92;275;-1;
2025-08-07 16:41:54.712;373;112;261;-1;
2025-08-07 16:41:55.211;373;112;261;-1;
2025-08-07 16:41:55.712;368;103;265;-1;
2025-08-07 16:41:56.211;368;103;265;-1;
2025-08-07 16:41:56.711;369;108;261;-1;
2025-08-07 16:41:57.210;369;108;261;-1;
2025-08-07 16:41:57.323;9;write_maxlimit_Modbus. Ecriture Modbus de power_limit = 18% (valeur 180 écrite dans le registre 40189)
2025-08-07 16:41:57.665;9;write_maxlimit_Modbus. Fin d'exécution de la procédure
2025-08-07 16:41:57.712;366;102;264;-1;
2025-08-07 16:41:58.212;366;102;264;-1;
2025-08-07 16:41:58.710;369;105;264;-1;
2025-08-07 16:41:59.211;369;105;264;-1;
2025-08-07 16:41:59.711;366;104;262;-1;
2025-08-07 16:42:00.212;366;104;262;-1;
2025-08-07 16:42:01.215;350;96;254;-1;
2025-08-07 16:42:01.713;337;75;262;-1;
2025-08-07 16:42:02.211;337;75;262;-1;
2025-08-07 16:42:02.712;330;71;259;-1;
2025-08-07 16:42:03.211;330;71;259;-1;
2025-08-07 16:42:03.711;331;71;260;-1;
2025-08-07 16:42:04.211;331;71;260;-1;
2025-08-07 16:42:04.711;333;73;260;-1;
2025-08-07 16:42:05.210;333;73;260;-1;
2025-08-07 16:42:05.711;332;68;264;-1;
2025-08-07 16:42:06.211;332;68;264;-1;
2025-08-07 16:42:06.710;329;69;260;-1;
2025-08-07 16:42:07.211;329;69;260;-1;
2025-08-07 16:42:07.711;331;70;261;-1;
2025-08-07 16:42:08.211;331;70;261;-1;
2025-08-07 16:42:08.710;333;72;261;-1;
2025-08-07 16:42:09.211;333;72;261;-1;
2025-08-07 16:42:09.774;328;65;263;-1;
2025-08-07 16:42:10.405;328;65;263;-1;
2025-08-07 16:42:10.711;326;67;259;-1;
2025-08-07 16:42:11.275;326;67;259;-1;
2025-08-07 16:42:11.914;330;67;263;-1;
2025-08-07 16:42:12.211;330;67;263;-1;
2025-08-07 16:42:12.808;332;63;269;-1;
2025-08-07 16:42:13.421;332;63;269;-1;
2025-08-07 16:42:13.752;329;66;263;-1;
2025-08-07 16:42:14.211;329;66;263;-1;
2025-08-07 16:42:14.711;332;69;263;-1;
2025-08-07 16:42:15.210;332;69;263;-1;
2025-08-07 16:42:15.710;334;72;262;-1;
2025-08-07 16:42:16.210;334;72;262;-1;
2025-08-07 16:42:16.711;330;68;262;-1;
2025-08-07 16:42:17.210;330;68;262;-1;
2025-08-07 16:42:17.710;330;71;259;-1;
2025-08-07 16:42:18.211;330;71;259;-1;
2025-08-07 16:42:18.714;332;63;269;-1;
2025-08-07 16:42:19.210;332;63;269;-1;
2025-08-07 16:42:19.710;330;68;262;-1;
2025-08-07 16:42:20.210;330;68;262;-1;
2025-08-07 16:42:20.711;329;68;261;-1;
2025-08-07 16:42:21.210;329;68;261;-1;
2025-08-07 16:42:21.710;330;70;260;-1;
2025-08-07 16:42:22.210;330;70;260;-1;
2025-08-07 16:42:22.713;331;52;279;-1;
2025-08-07 16:42:22.906;9;write_maxlimit_Modbus. Ecriture Modbus de power_limit = 16% (valeur 160 écrite dans le registre 40189)
2025-08-07 16:42:23.095;9;write_maxlimit_Modbus. Fin d'exécution de la procédure
2025-08-07 16:42:23.214;331;52;279;-1;
2025-08-07 16:42:23.713;334;69;265;-1;
2025-08-07 16:42:24.213;334;69;265;-1;
2025-08-07 16:42:24.710;330;68;262;-1;
2025-08-07 16:42:25.210;330;68;262;-1;
2025-08-07 16:42:25.710;330;68;262;-1;
2025-08-07 16:42:26.210;330;68;262;-1;
2025-08-07 16:42:26.710;329;67;262;-1;
2025-08-07 16:42:27.210;329;67;262;-1;
2025-08-07 16:42:27.716;317;56;261;-1;
2025-08-07 16:42:28.211;317;56;261;-1;
2025-08-07 16:42:28.735;297;35;262;-1;
2025-08-07 16:42:29.210;297;35;262;-1;
2025-08-07 16:42:29.718;293;31;262;-1;
2025-08-07 16:42:30.210;293;31;262;-1;
2025-08-07 16:42:30.710;294;32;262;-1;
2025-08-07 16:42:31.210;294;32;262;-1;
2025-08-07 16:42:31.712;294;31;263;-1;
2025-08-07 16:42:32.211;294;31;263;-1;
2025-08-07 16:42:32.710;292;31;261;-1;
2025-08-07 16:42:33.209;292;31;261;-1;
2025-08-07 16:42:33.710;293;31;262;-1;
2025-08-07 16:42:34.210;293;31;262;-1;
2025-08-07 16:42:34.722;294;33;261;-1;
2025-08-07 16:42:35.209;294;33;261;-1;
2025-08-07 16:42:35.710;293;31;262;-1;
2025-08-07 16:42:36.210;293;31;262;-1;
2025-08-07 16:42:36.724;294;25;269;-1;
2025-08-07 16:42:37.209;294;25;269;-1;
2025-08-07 16:42:37.725;295;33;262;-1;
2025-08-07 16:42:38.210;295;33;262;-1;
2025-08-07 16:42:38.710;295;32;263;-1;
2025-08-07 16:42:39.209;295;32;263;-1;
2025-08-07 16:42:39.727;293;30;263;-1;
2025-08-07 16:42:40.210;293;30;263;-1;
2025-08-07 16:42:40.727;289;28;261;-1;
2025-08-07 16:42:41.210;289;28;261;-1;
2025-08-07 16:42:41.710;293;30;263;-1;
2025-08-07 16:42:42.210;293;30;263;-1;
2025-08-07 16:42:42.710;297;34;263;-1;
2025-08-07 16:42:43.209;297;34;263;-1;
2025-08-07 16:42:43.710;294;32;262;-1;
2025-08-07 16:42:44.210;294;32;262;-1;
2025-08-07 16:42:44.710;294;31;263;-1;
2025-08-07 16:42:45.209;294;31;263;-1;
2025-08-07 16:42:45.709;293;27;266;-1;
2025-08-07 16:42:46.210;293;27;266;-1;
2025-08-07 16:42:46.710;293;25;268;-1;
2025-08-07 16:42:47.209;293;25;268;-1;
2025-08-07 16:42:47.709;293;23;270;-1;
2025-08-07 16:42:48.237;293;23;270;-1;
2025-08-07 16:42:48.710;293;25;268;-1;
2025-08-07 16:42:49.209;293;25;268;-1;
2025-08-07 16:42:49.709;294;14;280;-1;
2025-08-07 16:42:49.763;9;write_maxlimit_Modbus. Ecriture Modbus de power_limit = 18% (valeur 180 écrite dans le registre 40189)
2025-08-07 16:42:49.912;9;write_maxlimit_Modbus. Fin d'exécution de la procédure
2025-08-07 16:42:50.210;294;14;280;-1;
2025-08-07 16:42:50.709;291;18;273;-1;
2025-08-07 16:42:51.209;291;18;273;-1;
2025-08-07 16:42:51.709;294;32;262;-1;
2025-08-07 16:42:52.209;294;32;262;-1;
2025-08-07 16:42:52.709;294;29;265;-1;
2025-08-07 16:42:53.214;294;29;265;-1;
2025-08-07 16:42:53.710;298;35;263;-1;
2025-08-07 16:42:54.215;298;35;263;-1;
2025-08-07 16:42:54.710;314;53;261;-1;
2025-08-07 16:42:55.210;314;53;261;-1;
2025-08-07 16:42:55.709;321;57;264;-1;
2025-08-07 16:42:56.209;321;57;264;-1;
2025-08-07 16:42:56.709;319;55;264;-1;
2025-08-07 16:42:57.209;319;55;264;-1;
2025-08-07 16:42:57.710;318;42;276;-1;
2025-08-07 16:42:58.209;318;42;276;-1;
2025-08-07 16:42:58.709;318;54;264;-1;
2025-08-07 16:42:59.209;318;54;264;-1;
2025-08-07 16:42:59.710;317;53;264;-1;
2025-08-07 16:43:00.209;317;53;264;-1;
2025-08-07 16:43:00.913;318;54;264;-1;
2025-08-07 16:43:01.209;318;54;264;-1;
2025-08-07 16:43:01.710;317;52;265;-1;
2025-08-07 16:43:02.209;317;52;265;-1;
2025-08-07 16:43:02.709;318;56;262;-1;
2025-08-07 16:43:03.208;318;56;262;-1;
2025-08-07 16:43:03.709;318;57;261;-1;
2025-08-07 16:43:04.209;318;57;261;-1;
2025-08-07 16:43:04.708;319;56;263;-1;
2025-08-07 16:43:05.208;319;56;263;-1;
2025-08-07 16:43:05.708;320;56;264;-1;
2025-08-07 16:43:06.209;320;56;264;-1;
2025-08-07 16:43:06.708;316;53;263;-1;
2025-08-07 16:43:07.208;316;53;263;-1;
2025-08-07 16:43:07.709;318;50;268;-1;
2025-08-07 16:43:08.209;318;50;268;-1;
2025-08-07 16:43:08.709;319;52;267;-1;
2025-08-07 16:43:09.208;319;52;267;-1;
2025-08-07 16:43:09.709;318;56;262;-1;
2025-08-07 16:43:10.209;318;56;262;-1;
2025-08-07 16:43:10.709;317;55;262;-1;
2025-08-07 16:43:11.208;317;55;262;-1;
2025-08-07 16:43:11.709;318;56;262;-1;
2025-08-07 16:43:12.208;318;56;262;-1;
2025-08-07 16:43:12.708;318;56;262;-1;
2025-08-07 16:43:13.208;318;56;262;-1;
2025-08-07 16:43:13.708;317;55;262;-1;
2025-08-07 16:43:14.210;317;55;262;-1;
2025-08-07 16:43:14.708;318;57;261;-1;
2025-08-07 16:43:15.208;318;57;261;-1;
2025-08-07 16:43:15.708;316;51;265;-1;
2025-08-07 16:43:16.208;316;51;265;-1;
2025-08-07 16:43:16.708;319;53;266;-1;
2025-08-07 16:43:17.208;319;53;266;-1;
2025-08-07 16:43:17.709;323;59;264;-1;
2025-08-07 16:43:18.249;323;59;264;-1;
2025-08-07 16:43:18.866;318;51;267;-1;
2025-08-07 16:43:19.208;318;51;267;-1;
2025-08-07 16:43:19.779;316;51;265;-1;
2025-08-07 16:43:20.394;316;51;265;-1;
2025-08-07 16:43:20.712;315;51;264;-1;
2025-08-07 16:43:21.315;315;51;264;-1;
2025-08-07 16:43:21.928;325;51;274;-1;
2025-08-07 16:43:22.257;325;51;274;-1;
2025-08-07 16:43:22.713;317;54;263;-1;
2025-08-07 16:43:23.208;317;54;263;-1;
2025-08-07 16:43:23.714;320;59;261;-1;
2025-08-07 16:43:24.210;320;59;261;-1;
2025-08-07 16:43:24.715;319;57;262;-1;
2025-08-07 16:43:25.208;319;57;262;-1;
2025-08-07 16:43:25.715;317;54;263;-1;
2025-08-07 16:43:26.208;317;54;263;-1;
2025-08-07 16:43:26.717;319;56;263;-1;
2025-08-07 16:43:27.207;319;56;263;-1;
2025-08-07 16:43:27.718;318;58;260;-1;
2025-08-07 16:43:28.208;318;58;260;-1;
2025-08-07 16:43:28.302;9;write_maxlimit_Modbus. Ecriture Modbus de power_limit = 20% (valeur 200 écrite dans le registre 40189)
2025-08-07 16:43:28.465;9;write_maxlimit_Modbus. Fin d'exécution de la procédure
2025-08-07 16:43:28.719;320;51;269;-1;
2025-08-07 16:43:29.207;320;51;269;-1;
2025-08-07 16:43:29.720;318;40;278;-1;
2025-08-07 16:43:30.208;318;40;278;-1;
2025-08-07 16:43:30.721;317;53;264;-1;
2025-08-07 16:43:31.208;317;53;264;-1;
2025-08-07 16:43:31.738;317;47;270;-1;
2025-08-07 16:43:32.208;317;47;270;-1;
2025-08-07 16:43:32.739;319;57;262;-1;
2025-08-07 16:43:33.207;319;57;262;-1;
2025-08-07 16:43:33.744;338;77;261;-1;
2025-08-07 16:43:34.208;338;77;261;-1;
2025-08-07 16:43:34.743;358;96;262;-1;
2025-08-07 16:43:35.208;358;96;262;-1;
2025-08-07 16:43:35.724;358;95;263;-1;
2025-08-07 16:43:36.209;358;95;263;-1;
2025-08-07 16:43:36.726;356;93;263;-1;
2025-08-07 16:43:37.208;356;93;263;-1;
2025-08-07 16:43:37.727;357;92;265;-1;
2025-08-07 16:43:38.208;357;92;265;-1;
2025-08-07 16:43:38.728;356;93;263;-1;
2025-08-07 16:43:39.207;356;93;263;-1;
2025-08-07 16:43:39.746;354;90;264;-1;
2025-08-07 16:43:40.208;354;90;264;-1;
2025-08-07 16:43:40.729;357;94;263;-1;
2025-08-07 16:43:41.207;357;94;263;-1;
2025-08-07 16:43:41.727;357;94;263;-1;
2025-08-07 16:43:42.207;360;98;262;-1;
2025-08-07 16:43:42.726;360;98;262;-1;
2025-08-07 16:43:43.207;358;98;260;-1;
2025-08-07 16:43:43.727;358;98;260;-1;
2025-08-07 16:43:44.207;358;96;262;-1;
2025-08-07 16:43:44.727;358;96;262;-1;
2025-08-07 16:43:45.207;355;93;262;-1;
2025-08-07 16:43:45.726;355;93;262;-1;
2025-08-07 16:43:46.208;359;97;262;-1;
2025-08-07 16:43:46.727;359;97;262;-1;
2025-08-07 16:43:47.207;357;96;261;-1;
2025-08-07 16:43:47.726;357;96;261;-1;
2025-08-07 16:43:48.209;355;91;264;-1;
2025-08-07 16:43:48.751;355;91;264;-1;
2025-08-07 16:43:49.207;358;94;264;-1;
2025-08-07 16:43:49.726;358;94;264;-1;
2025-08-07 16:43:50.207;358;95;263;-1;
2025-08-07 16:43:50.726;358;95;263;-1;
2025-08-07 16:43:51.207;356;94;262;-1;
2025-08-07 16:43:51.726;356;94;262;-1;
2025-08-07 16:43:52.207;358;95;263;-1;
2025-08-07 16:43:52.726;358;95;263;-1;
2025-08-07 16:43:53.211;365;101;264;-1;
2025-08-07 16:43:53.726;365;101;264;-1;
2025-08-07 16:43:54.210;358;95;263;-1;
2025-08-07 16:43:54.727;358;95;263;-1;
2025-08-07 16:43:55.206;360;100;260;-1;
2025-08-07 16:43:55.726;360;100;260;-1;
2025-08-07 16:43:56.207;355;94;261;-1;
2025-08-07 16:43:56.726;355;94;261;-1;
2025-08-07 16:43:57.207;360;100;260;-1;
2025-08-07 16:43:57.727;360;100;260;-1;
2025-08-07 16:43:58.207;357;84;273;-1;
2025-08-07 16:43:58.727;357;84;273;-1;
2025-08-07 16:43:59.206;358;95;263;-1;
2025-08-07 16:43:59.726;358;95;263;-1;
2025-08-07 16:44:00.206;357;96;261;-1;
2025-08-07 16:44:00.858;357;96;261;-1;
2025-08-07 16:44:01.206;355;89;266;-1;
2025-08-07 16:44:01.726;355;89;266;-1;
2025-08-07 16:44:02.207;358;96;262;-1;
2025-08-07 16:44:02.726;358;96;262;-1;
2025-08-07 16:44:03.206;359;89;270;-1;
2025-08-07 16:44:03.726;359;89;270;-1;
2025-08-07 16:44:04.207;357;96;261;-1;
2025-08-07 16:44:04.725;357;96;261;-1;
2025-08-07 16:44:05.206;356;92;264;-1;
2025-08-07 16:44:05.726;356;92;264;-1;
2025-08-07 16:44:06.206;360;97;263;-1;
2025-08-07 16:44:06.726;360;97;263;-1;
2025-08-07 16:44:07.206;354;90;264;-1;
2025-08-07 16:44:07.726;354;90;264;-1;
2025-08-07 16:44:08.206;358;96;262;-1;
2025-08-07 16:44:08.726;358;96;262;-1;
2025-08-07 16:44:09.206;356;94;262;-1;
2025-08-07 16:44:09.726;356;94;262;-1;
2025-08-07 16:44:10.206;356;86;270;-1;
2025-08-07 16:44:10.725;356;86;270;-1;
2025-08-07 16:44:11.206;354;64;290;-1;
2025-08-07 16:44:11.726;354;64;290;-1;
2025-08-07 16:44:12.206;355;94;261;-1;
2025-08-07 16:44:12.725;355;94;261;-1;
2025-08-07 16:44:13.206;359;97;262;-1;
2025-08-07 16:44:13.726;359;97;262;-1;
2025-08-07 16:44:14.206;358;97;261;-1;
2025-08-07 16:44:14.725;358;97;261;-1;
2025-08-07 16:44:14.829;9;write_maxlimit_Modbus. Ecriture Modbus de power_limit = 19% (valeur 190 écrite dans le registre 40189)
2025-08-07 16:44:14.993;9;write_maxlimit_Modbus. Fin d'exécution de la procédure
2025-08-07 16:44:15.206;359;79;280;-1;
2025-08-07 16:44:15.726;359;79;280;-1;
2025-08-07 16:44:16.208;355;94;261;-1;
2025-08-07 16:44:16.725;355;94;261;-1;
2025-08-07 16:44:17.209;356;76;280;-1;
2025-08-07 16:44:17.725;356;76;280;-1;
2025-08-07 16:44:18.206;359;98;261;-1;
2025-08-07 16:44:18.726;359;98;261;-1;
2025-08-07 16:44:19.206;359;95;264;-1;
2025-08-07 16:44:19.725;359;95;264;-1;
2025-08-07 16:44:20.206;350;89;261;-1;
2025-08-07 16:44:20.726;350;89;261;-1;
2025-08-07 16:44:21.206;347;86;261;-1;
2025-08-07 16:44:21.725;347;86;261;-1;
2025-08-07 16:44:22.207;345;84;261;-1;
2025-08-07 16:44:22.725;345;84;261;-1;
2025-08-07 16:44:23.210;346;85;261;-1;
2025-08-07 16:44:23.725;346;85;261;-1;
2025-08-07 16:44:24.211;348;87;261;-1;
2025-08-07 16:44:24.726;348;87;261;-1;
2025-08-07 16:44:25.206;345;85;260;-1;
2025-08-07 16:44:25.725;345;85;260;-1;
2025-08-07 16:44:26.206;348;88;260;-1;
2025-08-07 16:44:26.725;348;88;260;-1;
2025-08-07 16:44:27.206;348;87;261;-1;
2025-08-07 16:44:27.725;348;87;261;-1;
2025-08-07 16:44:28.206;346;86;260;-1;
2025-08-07 16:44:28.725;346;86;260;-1;
2025-08-07 16:44:29.205;345;85;260;-1;
2025-08-07 16:44:29.725;345;85;260;-1;
2025-08-07 16:44:30.206;347;87;260;-1;
2025-08-07 16:44:30.725;347;87;260;-1;
2025-08-07 16:44:31.205;350;89;261;-1;
2025-08-07 16:44:31.725;350;89;261;-1;
2025-08-07 16:44:32.206;346;85;261;-1;
2025-08-07 16:44:32.725;346;85;261;-1;
2025-08-07 16:44:33.205;344;84;260;-1;
2025-08-07 16:44:33.725;344;84;260;-1;
2025-08-07 16:44:34.206;345;87;258;-1;
2025-08-07 16:44:34.724;345;87;258;-1;
2025-08-07 16:44:35.205;346;87;259;-1;
2025-08-07 16:44:35.725;346;87;259;-1;
2025-08-07 16:44:36.206;349;88;261;-1;
2025-08-07 16:44:36.725;349;88;261;-1;
2025-08-07 16:44:37.205;347;87;260;-1;
2025-08-07 16:44:37.725;347;87;260;-1;
2025-08-07 16:44:38.206;347;87;260;-1;
2025-08-07 16:44:38.724;347;87;260;-1;
2025-08-07 16:44:39.377;346;88;258;-1;
2025-08-07 16:44:39.725;346;88;258;-1;
2025-08-07 16:44:40.205;346;86;260;-1;
2025-08-07 16:44:40.878;346;86;260;-1;
2025-08-07 16:44:41.209;346;84;262;-1;
2025-08-07 16:44:41.825;346;84;262;-1;
2025-08-07 16:44:42.437;349;87;262;-1;
2025-08-07 16:44:42.719;349;87;262;-1;
2025-08-07 16:44:43.223;346;86;260;-1;
2025-08-07 16:44:43.705;346;86;260;-1;
2025-08-07 16:44:44.206;347;85;262;-1;
2025-08-07 16:44:44.705;347;85;262;-1;
2025-08-07 16:44:45.205;350;90;260;-1;
2025-08-07 16:44:45.705;350;90;260;-1;
2025-08-07 16:44:46.205;347;87;260;-1;
2025-08-07 16:44:46.705;347;87;260;-1;
2025-08-07 16:44:47.205;346;88;258;-1;
2025-08-07 16:44:47.705;346;88;258;-1;
2025-08-07 16:44:48.205;346;81;265;-1;
2025-08-07 16:44:48.697;9;write_maxlimit_Modbus. Ecriture Modbus de power_limit = 18% (valeur 180 écrite dans le registre 40189)
2025-08-07 16:44:48.745;346;81;265;-1;
2025-08-07 16:44:48.860;9;write_maxlimit_Modbus. Fin d'exécution de la procédure
2025-08-07 16:44:49.207;346;65;281;-1;
2025-08-07 16:44:49.704;346;65;281;-1;
2025-08-07 16:44:50.205;346;69;277;-1;
2025-08-07 16:44:50.705;346;69;277;-1;
2025-08-07 16:44:51.205;337;74;263;-1;
2025-08-07 16:44:51.705;337;74;263;-1;
2025-08-07 16:44:52.205;332;70;262;-1;
2025-08-07 16:44:52.705;332;70;262;-1;
2025-08-07 16:44:53.207;332;70;262;-1;
2025-08-07 16:44:53.705;332;70;262;-1;
2025-08-07 16:44:54.210;332;71;261;-1;
2025-08-07 16:44:54.705;332;71;261;-1;
2025-08-07 16:44:55.204;330;70;260;-1;
2025-08-07 16:44:55.705;330;70;260;-1;
2025-08-07 16:44:56.205;328;69;259;-1;
2025-08-07 16:44:56.704;328;69;259;-1;
2025-08-07 16:44:57.205;330;68;262;-1;
2025-08-07 16:44:57.704;330;68;262;-1;
2025-08-07 16:44:58.206;330;65;265;-1;
2025-08-07 16:44:58.705;330;65;265;-1;
2025-08-07 16:44:59.205;328;68;260;-1;
2025-08-07 16:44:59.704;328;68;260;-1;
2025-08-07 16:45:00.206;331;72;259;-1;
2025-08-07 16:45:00.704;331;72;259;-1;
2025-08-07 16:45:01.204;330;69;261;-1;
2025-08-07 16:45:01.704;330;69;261;-1;
2025-08-07 16:45:02.205;329;69;260;-1;
2025-08-07 16:45:02.705;329;69;260;-1;
2025-08-07 16:45:03.205;331;68;263;-1;
2025-08-07 16:45:03.704;331;68;263;-1;
2025-08-07 16:45:04.205;330;68;262;-1;
2025-08-07 16:45:04.704;330;68;262;-1;
2025-08-07 16:45:05.205;331;69;262;-1;
2025-08-07 16:45:05.705;331;69;262;-1;
2025-08-07 16:45:06.204;331;71;260;-1;
2025-08-07 16:45:06.705;331;71;260;-1;
2025-08-07 16:45:07.205;331;71;260;-1;
2025-08-07 16:45:07.704;331;71;260;-1;
2025-08-07 16:45:08.204;331;72;259;-1;
2025-08-07 16:45:08.704;331;72;259;-1;
2025-08-07 16:45:09.204;331;64;267;-1;
2025-08-07 16:45:09.703;331;64;267;-1;
2025-08-07 16:45:10.205;331;60;271;-1;
2025-08-07 16:45:10.704;331;60;271;-1;
2025-08-07 16:45:11.204;332;71;261;-1;
2025-08-07 16:45:11.703;332;71;261;-1;
2025-08-07 16:45:12.205;330;63;267;-1;
2025-08-07 16:45:12.703;330;63;267;-1;
2025-08-07 16:45:13.065;9;write_maxlimit_Modbus. Ecriture Modbus de power_limit = 19% (valeur 190 écrite dans le registre 40189)
2025-08-07 16:45:13.204;330;52;278;-1;
2025-08-07 16:45:13.259;9;write_maxlimit_Modbus. Fin d'exécution de la procédure
2025-08-07 16:45:13.704;330;52;278;-1;
2025-08-07 16:45:14.204;333;73;260;-1;
2025-08-07 16:45:14.704;333;73;260;-1;
2025-08-07 16:45:15.204;331;69;262;-1;
2025-08-07 16:45:15.703;331;69;262;-1;
2025-08-07 16:45:16.204;330;72;258;-1;
2025-08-07 16:45:16.704;330;72;258;-1;
2025-08-07 16:45:17.204;333;71;262;-1;
2025-08-07 16:45:17.703;333;71;262;-1;
2025-08-07 16:45:18.204;331;71;260;-1;
2025-08-07 16:45:18.703;331;71;260;-1;
2025-08-07 16:45:19.205;335;73;262;-1;
2025-08-07 16:45:19.703;335;73;262;-1;
2025-08-07 16:45:20.204;338;77;261;-1;
2025-08-07 16:45:20.703;338;77;261;-1;
2025-08-07 16:45:21.203;339;79;260;-1;
2025-08-07 16:45:21.703;339;79;260;-1;
2025-08-07 16:45:22.204;339;78;261;-1;
2025-08-07 16:45:22.704;339;78;261;-1;
2025-08-07 16:45:23.207;341;80;261;-1;
2025-08-07 16:45:23.704;341;80;261;-1;
2025-08-07 16:45:24.206;341;81;260;-1;
2025-08-07 16:45:24.704;341;81;260;-1;
2025-08-07 16:45:25.203;340;81;259;-1;
2025-08-07 16:45:25.703;340;81;259;-1;
2025-08-07 16:45:26.204;340;79;261;-1;
2025-08-07 16:45:26.703;340;79;261;-1;
2025-08-07 16:45:27.203;339;77;262;-1;
2025-08-07 16:45:27.703;339;77;262;-1;
2025-08-07 16:45:28.203;339;80;259;-1;
2025-08-07 16:45:28.703;339;80;259;-1;
2025-08-07 16:45:29.203;338;78;260;-1;
2025-08-07 16:45:29.703;338;78;260;-1;
2025-08-07 16:45:30.204;339;77;262;-1;
2025-08-07 16:45:30.703;339;77;262;-1;
2025-08-07 16:45:31.203;339;78;261;-1;
2025-08-07 16:45:31.703;339;78;261;-1;
2025-08-07 16:45:32.203;339;78;261;-1;
2025-08-07 16:45:32.703;339;78;261;-1;
2025-08-07 16:45:33.203;341;78;263;-1;
2025-08-07 16:45:33.709;341;78;263;-1;
2025-08-07 16:45:34.203;341;79;262;-1;
2025-08-07 16:45:34.704;341;79;262;-1;
2025-08-07 16:45:35.203;337;76;261;-1;
2025-08-07 16:45:35.703;337;76;261;-1;
2025-08-07 16:45:36.203;338;78;260;-1;
2025-08-07 16:45:36.703;338;78;260;-1;
2025-08-07 16:45:37.203;340;79;261;-1;
2025-08-07 16:45:37.703;340;79;261;-1;
2025-08-07 16:45:38.203;338;78;260;-1;
2025-08-07 16:45:38.703;338;78;260;-1;
2025-08-07 16:45:39.203;341;78;263;-1;
2025-08-07 16:45:39.702;341;78;263;-1;
2025-08-07 16:45:40.203;338;76;262;-1;
2025-08-07 16:45:40.703;338;76;262;-1;
2025-08-07 16:45:41.203;338;65;273;-1;
2025-08-07 16:45:41.703;338;65;273;-1;
2025-08-07 16:45:42.203;340;74;266;-1;
2025-08-07 16:45:42.703;340;74;266;-1;
2025-08-07 16:45:43.203;343;79;264;-1;
2025-08-07 16:45:43.702;343;79;264;-1;
2025-08-07 16:45:44.203;346;85;261;-1;
2025-08-07 16:45:44.702;346;85;261;-1;
2025-08-07 16:45:45.202;342;81;261;-1;
2025-08-07 16:45:45.702;342;81;261;-1;
2025-08-07 16:45:46.204;337;74;263;-1;
2025-08-07 16:45:46.702;337;74;263;-1;
2025-08-07 16:45:47.202;340;79;261;-1;
2025-08-07 16:45:47.746;340;79;261;-1;
2025-08-07 16:45:47.793;9;write_maxlimit_Modbus. Ecriture Modbus de power_limit = 20% (valeur 200 écrite dans le registre 40189)
2025-08-07 16:45:48.181;9;write_maxlimit_Modbus. Fin d'exécution de la procédure
2025-08-07 16:45:48.465;339;68;271;-1;
2025-08-07 16:45:48.810;339;68;271;-1;
2025-08-07 16:45:49.274;337;65;272;-1;
2025-08-07 16:45:49.703;337;65;272;-1;
2025-08-07 16:45:50.318;339;66;273;-1;
2025-08-07 16:45:50.702;339;66;273;-1;
2025-08-07 16:45:51.229;348;84;264;-1;
2025-08-07 16:45:51.841;348;84;264;-1;
2025-08-07 16:45:52.202;360;101;259;-1;
2025-08-07 16:45:52.702;360;101;259;-1;
2025-08-07 16:45:53.207;363;104;259;-1;
2025-08-07 16:45:53.702;363;104;259;-1;
2025-08-07 16:45:54.207;361;101;260;-1;
2025-08-07 16:45:54.702;361;101;260;-1;
2025-08-07 16:45:55.203;362;102;260;-1;
2025-08-07 16:45:55.702;362;102;260;-1;
2025-08-07 16:45:56.203;365;107;258;-1;
2025-08-07 16:45:56.702;365;107;258;-1;
2025-08-07 16:45:57.203;361;101;260;-1;
2025-08-07 16:45:57.712;361;101;260;-1;
2025-08-07 16:45:58.203;360;100;260;-1;
2025-08-07 16:45:58.702;360;100;260;-1;
2025-08-07 16:45:59.202;365;110;255;-1;
2025-08-07 16:45:59.702;365;110;255;-1;
2025-08-07 16:46:00.203;360;99;261;-1;
2025-08-07 16:46:00.702;360;99;261;-1;
2025-08-07 16:46:01.202;358;98;260;-1;
2025-08-07 16:46:01.703;358;98;260;-1;
2025-08-07 16:46:02.202;358;85;273;-1;
2025-08-07 16:46:02.703;358;85;273;-1;
2025-08-07 16:46:03.202;359;102;257;-1;
2025-08-07 16:46:03.702;359;102;257;-1;
2025-08-07 16:46:04.203;360;103;257;-1;
2025-08-07 16:46:04.702;360;103;257;-1;
2025-08-07 16:46:05.202;361;104;257;-1;
2025-08-07 16:46:05.702;361;104;257;-1;
2025-08-07 16:46:06.202;361;105;256;-1;
2025-08-07 16:46:06.702;361;105;256;-1;
2025-08-07 16:46:07.202;361;105;256;-1;
2025-08-07 16:46:07.702;361;105;256;-1;
2025-08-07 16:46:08.202;359;102;257;-1;
2025-08-07 16:46:08.702;359;102;257;-1;
2025-08-07 16:46:09.202;360;104;256;-1;
2025-08-07 16:46:09.701;360;104;256;-1;
2025-08-07 16:46:10.202;359;103;256;-1;
2025-08-07 16:46:10.702;359;103;256;-1;
2025-08-07 16:46:11.201;361;105;256;-1;
2025-08-07 16:46:11.701;361;105;256;-1;
2025-08-07 16:46:12.202;358;105;253;-1;
2025-08-07 16:46:12.702;358;105;253;-1;
2025-08-07 16:46:13.201;358;103;255;-1;
2025-08-07 16:46:13.701;358;103;255;-1;
2025-08-07 16:46:14.202;358;103;255;-1;
2025-08-07 16:46:14.701;358;103;255;-1;
2025-08-07 16:46:15.202;377;121;256;-1;
2025-08-07 16:46:15.420;9;write_maxlimit_Modbus. Ecriture Modbus de power_limit = 100% (valeur 1000 écrite dans le registre 40189)
2025-08-07 16:46:15.612;9;write_maxlimit_Modbus. Fin d'exécution de la procédure
2025-08-07 16:46:15.702;377;121;256;-1;
2025-08-07 16:46:16.202;380;123;257;-1;
2025-08-07 16:46:16.701;380;123;257;-1;
2025-08-07 16:46:17.201;390;124;266;-1;
2025-08-07 16:46:17.701;390;124;266;-1;
2025-08-07 16:46:18.210;534;278;256;-1;
2025-08-07 16:46:18.702;534;278;256;-1;
2025-08-07 16:46:19.202;620;362;258;-1;
2025-08-07 16:46:19.702;620;362;258;-1;
2025-08-07 16:46:20.202;710;454;256;-1;
2025-08-07 16:46:20.702;710;454;256;-1;
2025-08-07 16:46:21.201;748;481;267;-1;
2025-08-07 16:46:21.702;748;481;267;-1;
2025-08-07 16:46:22.202;800;542;258;-1;
2025-08-07 16:46:22.701;800;542;258;-1;
2025-08-07 16:46:23.204;872;613;259;-1;
2025-08-07 16:46:23.701;872;613;259;-1;
2025-08-07 16:46:24.205;939;684;255;-1;
2025-08-07 16:46:24.701;939;684;255;-1;
2025-08-07 16:46:25.202;1012;753;259;-1;
2025-08-07 16:46:25.702;1012;753;259;-1;
2025-08-07 16:46:26.202;1066;809;257;-1;
2025-08-07 16:46:26.701;1066;809;257;-1;
2025-08-07 16:46:27.201;1137;878;259;-1;
2025-08-07 16:46:27.701;1137;878;259;-1;
2025-08-07 16:46:28.201;1199;928;271;-1;
2025-08-07 16:46:28.701;1199;928;271;-1;
2025-08-07 16:46:29.201;1254;995;259;-1;
2025-08-07 16:46:29.701;1254;995;259;-1;
2025-08-07 16:46:30.202;1322;1062;260;-1;
2025-08-07 16:46:30.701;1322;1062;260;-1;
2025-08-07 16:46:31.201;1370;1111;259;-1;
2025-08-07 16:46:31.701;1370;1111;259;-1;
2025-08-07 16:46:32.202;1418;1160;258;-1;
2025-08-07 16:46:32.701;1418;1160;258;-1;
2025-08-07 16:46:33.201;1451;1193;258;-1;
2025-08-07 16:46:33.701;1451;1193;258;-1;
2025-08-07 16:46:34.201;1482;1223;259;-1;
2025-08-07 16:46:34.701;1482;1223;259;-1;
2025-08-07 16:46:35.201;1498;1239;259;-1;
2025-08-07 16:46:35.701;1498;1239;259;-1;
2025-08-07 16:46:36.201;1497;1237;260;-1;
2025-08-07 16:46:36.701;1497;1237;260;-1;
2025-08-07 16:46:37.201;1499;1240;259;-1;
2025-08-07 16:46:37.700;1499;1240;259;-1;
2025-08-07 16:46:38.201;1497;1235;262;-1;
2025-08-07 16:46:38.700;1497;1235;262;-1;
2025-08-07 16:46:39.201;1498;1238;260;-1;
2025-08-07 16:46:39.700;1498;1238;260;-1;
2025-08-07 16:46:40.201;1499;1238;261;-1;
2025-08-07 16:46:40.700;1499;1238;261;-1;
2025-08-07 16:46:41.201;1501;1241;260;-1;
2025-08-07 16:46:41.700;1501;1241;260;-1;
2025-08-07 16:46:42.201;1499;1239;260;-1;
2025-08-07 16:46:42.701;1499;1239;260;-1;
2025-08-07 16:46:43.201;1499;1239;260;-1;
2025-08-07 16:46:43.700;1499;1239;260;-1;
2025-08-07 16:46:44.201;1500;1243;257;-1;
2025-08-07 16:46:44.701;1500;1243;257;-1;
2025-08-07 16:46:45.201;1499;1241;258;-1;
2025-08-07 16:46:45.700;1499;1241;258;-1;
2025-08-07 16:46:46.200;1494;1234;260;-1;
2025-08-07 16:46:46.700;1494;1234;260;-1;
2025-08-07 16:46:47.201;1494;1235;259;-1;
2025-08-07 16:46:47.700;1494;1235;259;-1;
2025-08-07 16:46:48.200;1501;1240;261;-1;
2025-08-07 16:46:48.700;1501;1240;261;-1;
2025-08-07 16:46:49.203;1497;1237;260;-1;
2025-08-07 16:46:49.701;1497;1237;260;-1;
2025-08-07 16:46:50.201;1499;1239;260;-1;
2025-08-07 16:46:50.700;1499;1239;260;-1;
2025-08-07 16:46:54.963;1501;1239;262;-1;
2025-08-07 16:46:54.970;1501;1239;262;-1;
2025-08-07 16:46:54.973;1497;1240;257;-1;
2025-08-07 16:46:54.976;1497;1240;257;-1;
2025-08-07 16:46:54.979;1500;1241;259;-1;
2025-08-07 16:46:54.985;1500;1241;259;-1;
2025-08-07 16:46:54.988;1501;1245;256;-1;
2025-08-07 16:46:54.990;1501;1245;256;-1;
2025-08-07 16:46:55.200;1499;1242;257;-1;
2025-08-07 16:46:55.700;1499;1242;257;-1;
2025-08-07 16:46:56.200;1496;1238;258;-1;
2025-08-07 16:46:56.700;1496;1238;258;-1;
2025-08-07 16:46:57.200;1497;1240;257;-1;
2025-08-07 16:46:57.699;1497;1240;257;-1;
